"","participant_id","ID","trial","Treatment","Beh","SI_PN","PN_1","PN_2","IB_1","IB_2","PN_moves","IB_moves","Treatment_GN","subCloseness","order","cohort","cohort_rec","domain"
"1",1,"1",1,"Prosocial","vegetarian",11,9,8,3,7,-1,4,2,3,2,"younger","1","1"
"2",1,"1",4,"Antisocial","distance",8,10,4,7,3,-6,-4,-2,3,2,"younger","1","0"
"3",1,"1",6,"Prosocial","speed",11,9,11,6,7,2,1,2,3,2,"younger","1","1"
"4",1,"1",7,"Prosocial","bike",10,8,5,2,5,-3,3,2,3,2,"younger","1","1"
"5",1,"1",8,"Antisocial","heating",4,6,7,3,3,1,0,-2,3,2,"younger","1","0"
"6",1,"1",10,"Antisocial","lights",6,8,8,5,5,0,0,-2,3,2,"younger","1","0"
"7",1,"1",11,"Prosocial","seatBus",8,6,9,3,5,3,2,2,3,2,"younger","1","1"
"8",1,"1",12,"Antisocial","chargers",4,6,7,5,4,1,-1,-2,3,2,"younger","1","0"
"9",2,"2",2,"Antisocial","coughelbow",2,4,3,6,5,-1,-1,-2,5,2,"younger","1","0"
"10",2,"2",3,"Antisocial","chargers",4,6,5,7,7,-1,0,-2,5,2,"younger","1","0"
"11",2,"2",9,"Antisocial","lights",6,8,6,6,7,-2,1,-2,5,2,"younger","1","0"
"12",2,"2",10,"Antisocial","distance",9,11,11,3,7,0,4,-2,5,2,"younger","1","0"
"13",2,"2",11,"Prosocial","screentime",8,6,6,3,4,0,1,2,5,2,"younger","1","1"
"14",3,"3",1,"Prosocial","bike",10,8,11,2,4,3,2,2,3,1,"younger","1","1"
"15",3,"3",3,"Antisocial","meat",8,10,10,7,7,0,0,-2,3,1,"younger","1","0"
"16",3,"3",4,"Prosocial","speed",8,6,9,4,5,3,1,2,3,1,"younger","1","1"
"17",3,"3",5,"Prosocial","vegetarian",8,6,6,1,2,0,1,2,3,1,"younger","1","1"
"18",3,"3",9,"Antisocial","lights",4,6,7,5,5,1,0,-2,3,1,"younger","1","0"
"19",3,"3",10,"Antisocial","download",5,7,8,5,5,1,0,-2,3,1,"younger","1","0"
"20",3,"3",11,"Antisocial","distance",1,3,1,5,2,-2,-3,-2,3,1,"younger","1","0"
"21",3,"3",12,"Prosocial","homeless",11,9,9,3,4,0,1,2,3,1,"younger","1","1"
"22",4,"4",2,"Antisocial","parking",3,5,3,5,2,-2,-3,-2,5,1,"younger","1","0"
"23",4,"4",3,"Antisocial","late",2,4,3,4,2,-1,-2,-2,5,1,"younger","1","0"
"24",4,"4",4,"Antisocial","shower",4,6,6,4,3,0,-1,-2,5,1,"younger","1","0"
"25",4,"4",6,"Antisocial","lights",4,6,4,4,3,-2,-1,-2,5,1,"younger","1","0"
"26",4,"4",7,"Prosocial","volunteer",9,7,8,4,5,1,1,2,5,1,"younger","1","1"
"27",4,"4",10,"Prosocial","lendMoney",9,7,9,4,5,2,1,2,5,1,"younger","1","1"
"28",4,"4",11,"Prosocial","sustainable",8,6,8,4,5,2,1,2,5,1,"younger","1","1"
"29",4,"4",12,"Prosocial","vegetarian",8,6,7,2,4,1,2,2,5,1,"younger","1","1"
"30",5,"5",1,"Antisocial","lights",1,3,1,2,1,-2,-1,-2,4,2,"younger","1","0"
"31",5,"5",2,"Prosocial","bike",6,4,2,1,2,-2,1,2,4,2,"younger","1","1"
"32",5,"5",4,"Prosocial","crossroad",8,6,6,4,4,0,0,2,4,2,"younger","1","1"
"33",5,"5",5,"Antisocial","download",4,6,6,4,4,0,0,-2,4,2,"younger","1","0"
"34",5,"5",6,"Prosocial","sustainable",8,6,8,4,6,2,2,2,4,2,"younger","1","1"
"35",5,"5",8,"Antisocial","shower",4,6,6,4,4,0,0,-2,4,2,"younger","1","0"
"36",5,"5",9,"Antisocial","chargers",8,10,9,7,7,-1,0,-2,4,2,"younger","1","0"
"37",5,"5",11,"Prosocial","volunteer",7,5,6,2,4,1,2,2,4,2,"younger","1","1"
"38",6,"6",1,"Antisocial","late",2,4,1,2,2,-3,0,-2,5,2,"younger","1","0"
"39",6,"6",2,"Antisocial","heating",2,4,2,2,4,-2,2,-2,5,2,"younger","1","0"
"40",6,"6",3,"Prosocial","sustainable",10,8,11,3,5,3,2,2,5,2,"younger","1","1"
"41",6,"6",4,"Prosocial","seatBus",6,4,9,4,3,5,-1,2,5,2,"younger","1","1"
"42",6,"6",6,"Prosocial","washands",11,9,10,5,5,1,0,2,5,2,"younger","1","1"
"43",6,"6",7,"Prosocial","bike",11,9,10,2,3,1,1,2,5,2,"younger","1","1"
"44",6,"6",9,"Antisocial","shower",2,4,2,2,2,-2,0,-2,5,2,"younger","1","0"
"45",6,"6",10,"Antisocial","chargers",7,9,5,6,7,-4,1,-2,5,2,"younger","1","0"
"46",7,"7",1,"Antisocial","parking",1,3,2,2,2,-1,0,-2,5,1,"younger","1","0"
"47",7,"7",4,"Antisocial","chargers",5,7,7,6,7,0,1,-2,5,1,"younger","1","0"
"48",7,"7",5,"Prosocial","vegetarian",11,9,9,2,3,0,1,2,5,1,"younger","1","1"
"49",7,"7",6,"Antisocial","lights",6,8,4,5,6,-4,1,-2,5,1,"younger","1","0"
"50",7,"7",8,"Prosocial","screentime",10,8,10,5,7,2,2,2,5,1,"younger","1","1"
"51",7,"7",10,"Prosocial","bike",11,9,10,2,2,1,0,2,5,1,"younger","1","1"
"52",7,"7",11,"Prosocial","volunteer",11,9,9,3,7,0,4,2,5,1,"younger","1","1"
"53",7,"7",12,"Antisocial","download",6,8,8,6,6,0,0,-2,5,1,"younger","1","0"
"54",8,"8",2,"Prosocial","speed",9,7,8,5,5,1,0,2,3,2,"younger","1","1"
"55",8,"8",3,"Antisocial","download",1,3,1,2,1,-2,-1,-2,3,2,"younger","1","0"
"56",8,"8",4,"Prosocial","bike",9,7,8,3,5,1,2,2,3,2,"younger","1","1"
"57",8,"8",5,"Antisocial","noisedisturbance",1,3,2,3,1,-1,-2,-2,3,2,"younger","1","0"
"58",8,"8",6,"Antisocial","chargers",1,3,2,3,2,-1,-1,-2,3,2,"younger","1","0"
"59",8,"8",8,"Prosocial","recycle",10,8,9,3,6,1,3,2,3,2,"younger","1","1"
"60",8,"8",10,"Prosocial","screentime",9,7,9,5,6,2,1,2,3,2,"younger","1","1"
"61",8,"8",11,"Antisocial","late",2,4,3,5,2,-1,-3,-2,3,2,"younger","1","0"
"62",9,"9",1,"Prosocial","lendMoney",8,6,9,2,6,3,4,2,6,1,"younger","1","1"
"63",9,"9",3,"Antisocial","shower",4,6,6,4,4,0,0,-2,6,1,"younger","1","0"
"64",9,"9",4,"Prosocial","screentime",8,6,9,2,5,3,3,2,6,1,"younger","1","1"
"65",9,"9",6,"Antisocial","heating",4,6,3,2,2,-3,0,-2,6,1,"younger","1","0"
"66",9,"9",8,"Prosocial","bike",8,6,9,4,4,3,0,2,6,1,"younger","1","1"
"67",9,"9",9,"Prosocial","queue",3,1,2,2,2,1,0,2,6,1,"younger","1","1"
"68",9,"9",10,"Antisocial","distance",9,11,11,7,7,0,0,-2,6,1,"younger","1","0"
"69",9,"9",11,"Antisocial","coughelbow",4,6,3,4,2,-3,-2,-2,6,1,"younger","1","0"
"70",10,"10",2,"Antisocial","download",4,6,1,2,1,-5,-1,-2,3,2,"younger","1","0"
"71",10,"10",3,"Antisocial","distance",3,5,5,3,3,0,0,-2,3,2,"younger","1","0"
"72",10,"10",4,"Antisocial","chargers",3,5,5,5,5,0,0,-2,3,2,"younger","1","0"
"73",10,"10",7,"Prosocial","lendMoney",9,7,10,2,4,3,2,2,3,2,"younger","1","1"
"74",10,"10",8,"Prosocial","seatBus",11,9,9,3,7,0,4,2,3,2,"younger","1","1"
"75",10,"10",9,"Prosocial","recycle",10,8,9,5,6,1,1,2,3,2,"younger","1","1"
"76",10,"10",10,"Prosocial","screentime",9,7,6,2,2,-1,0,2,3,2,"younger","1","1"
"77",10,"10",11,"Antisocial","shower",2,4,1,6,1,-3,-5,-2,3,2,"younger","1","0"
"78",11,"11",1,"Antisocial","distance",8,10,4,7,3,-6,-4,-2,5,2,"younger","1","0"
"79",11,"11",2,"Prosocial","seatBus",11,9,11,4,5,2,1,2,5,2,"younger","1","1"
"80",11,"11",5,"Antisocial","late",4,6,5,4,4,-1,0,-2,5,2,"younger","1","0"
"81",11,"11",7,"Prosocial","vegetarian",10,8,11,2,2,3,0,2,5,2,"younger","1","1"
"82",11,"11",8,"Prosocial","queue",11,9,11,5,5,2,0,2,5,2,"younger","1","1"
"83",11,"11",9,"Antisocial","chargers",4,6,5,6,5,-1,-1,-2,5,2,"younger","1","0"
"84",11,"11",10,"Prosocial","sustainable",11,9,11,3,5,2,2,2,5,2,"younger","1","1"
"85",11,"11",11,"Antisocial","shower",2,4,2,4,4,-2,0,-2,5,2,"younger","1","0"
"86",12,"12",2,"Antisocial","alcoholWork",3,5,2,2,2,-3,0,-2,7,1,"younger","1","0"
"87",12,"12",4,"Prosocial","queue",5,3,1,1,1,-2,0,2,7,1,"younger","1","1"
"88",12,"12",6,"Antisocial","travelticket",6,8,4,2,3,-4,1,-2,7,1,"younger","1","0"
"89",12,"12",7,"Antisocial","shower",7,9,9,6,7,0,1,-2,7,1,"younger","1","0"
"90",12,"12",9,"Prosocial","homeless",9,7,9,6,6,2,0,2,7,1,"younger","1","1"
"91",12,"12",10,"Antisocial","distance",1,3,1,2,1,-2,-1,-2,7,1,"younger","1","0"
"92",12,"12",11,"Prosocial","sustainable",7,5,9,3,5,4,2,2,7,1,"younger","1","1"
"93",12,"12",12,"Prosocial","volunteer",9,7,7,5,6,0,1,2,7,1,"younger","1","1"
"94",13,"13",1,"Antisocial","chargers",8,10,11,7,7,1,0,-2,4,1,"younger","1","0"
"95",13,"13",2,"Antisocial","meat",9,11,11,7,7,0,0,-2,4,1,"younger","1","0"
"96",13,"13",4,"Prosocial","speed",6,4,6,2,4,2,2,2,4,1,"younger","1","1"
"97",13,"13",6,"Prosocial","screentime",9,7,9,5,4,2,-1,2,4,1,"younger","1","1"
"98",13,"13",8,"Antisocial","download",5,7,8,7,6,1,-1,-2,4,1,"younger","1","0"
"99",13,"13",10,"Antisocial","alcoholWork",1,6,1,1,1,-5,0,-5,4,1,"younger","1","0"
"100",13,"13",11,"Prosocial","queue",8,6,4,1,1,-2,0,2,4,1,"younger","1","1"
"101",13,"13",12,"Prosocial","vegetarian",8,6,8,1,1,2,0,2,4,1,"younger","1","1"
"102",14,"14",1,"Prosocial","homeless",10,8,9,2,2,1,0,2,6,2,"younger","1","1"
"103",14,"14",2,"Antisocial","chargers",4,6,5,2,6,-1,4,-2,6,2,"younger","1","0"
"104",14,"14",3,"Prosocial","speed",7,5,7,2,7,2,5,2,6,2,"younger","1","1"
"105",14,"14",6,"Prosocial","sustainable",11,9,11,2,2,2,0,2,6,2,"younger","1","1"
"106",14,"14",7,"Antisocial","distance",8,10,10,2,7,0,5,-2,6,2,"younger","1","0"
"107",14,"14",10,"Prosocial","lendMoney",8,6,6,1,5,0,4,2,6,2,"younger","1","1"
"108",14,"14",11,"Antisocial","download",4,6,6,3,6,0,3,-2,6,2,"younger","1","0"
"109",15,"15",3,"Antisocial","coughelbow",4,6,4,4,2,-2,-2,-2,6,1,"younger","1","0"
"110",15,"15",4,"Antisocial","distance",9,11,11,7,7,0,0,-2,6,1,"younger","1","0"
"111",15,"15",5,"Prosocial","bike",11,9,10,4,6,1,2,2,6,1,"younger","1","1"
"112",15,"15",7,"Antisocial","noisedisturbance",1,3,1,2,1,-2,-1,-2,6,1,"younger","1","0"
"113",15,"15",8,"Antisocial","shower",4,6,4,3,3,-2,0,-2,6,1,"younger","1","0"
"114",15,"15",10,"Prosocial","seatBus",10,8,11,5,7,3,2,2,6,1,"younger","1","1"
"115",15,"15",11,"Prosocial","vegetarian",8,6,11,5,6,5,1,2,6,1,"younger","1","1"
"116",15,"15",12,"Prosocial","queue",4,2,3,1,2,1,1,2,6,1,"younger","1","1"
"117",16,"16",2,"Antisocial","heating",4,6,3,3,2,-3,-1,-2,2,2,"younger","1","0"
"118",16,"16",3,"Antisocial","alcoholWork",4,6,4,2,2,-2,0,-2,2,2,"younger","1","0"
"119",16,"16",4,"Prosocial","seatBus",10,8,11,3,4,3,1,2,2,2,"younger","1","1"
"120",16,"16",6,"Prosocial","queue",9,7,9,2,5,2,3,2,2,2,"younger","1","1"
"121",16,"16",7,"Antisocial","gathering",7,9,7,7,5,-2,-2,-2,2,2,"younger","1","0"
"122",16,"16",9,"Prosocial","vegetarian",7,5,4,1,1,-1,0,2,2,2,"younger","1","1"
"123",16,"16",10,"Antisocial","chargers",4,6,8,7,7,2,0,-2,2,2,"younger","1","0"
"124",16,"16",12,"Prosocial","charity",11,9,11,2,7,2,5,2,2,2,"younger","1","1"
"125",17,"17",1,"Antisocial","distance",2,4,2,2,1,-2,-1,-2,3,1,"younger","1","0"
"126",17,"17",2,"Prosocial","recycle",11,9,11,5,7,2,2,2,3,1,"younger","1","1"
"127",17,"17",3,"Antisocial","alcoholWork",1,2,1,1,1,-1,0,-1,3,1,"younger","1","0"
"128",17,"17",4,"Prosocial","bike",10,8,9,1,3,1,2,2,3,1,"younger","1","1"
"129",17,"17",5,"Antisocial","chargers",4,6,6,7,6,0,-1,-2,3,1,"younger","1","0"
"130",17,"17",9,"Antisocial","shower",4,6,5,6,5,-1,-1,-2,3,1,"younger","1","0"
"131",17,"17",11,"Prosocial","charity",10,8,11,1,4,3,3,2,3,1,"younger","1","1"
"132",17,"17",12,"Prosocial","organicVegetables",9,7,8,2,4,1,2,2,3,1,"younger","1","1"
"133",18,"18",1,"Prosocial","queue",8,6,6,3,5,0,2,2,3,2,"younger","1","1"
"134",18,"18",2,"Antisocial","shower",4,6,2,4,1,-4,-3,-2,3,2,"younger","1","0"
"135",18,"18",3,"Antisocial","taxes",1,3,1,2,1,-2,-1,-2,3,2,"younger","1","0"
"136",18,"18",5,"Antisocial","meat",6,8,9,7,7,1,0,-2,3,2,"younger","1","0"
"137",18,"18",7,"Prosocial","vegetarian",10,8,8,6,3,0,-3,2,3,2,"younger","1","1"
"138",18,"18",8,"Antisocial","late",2,4,2,4,1,-2,-3,-2,3,2,"younger","1","0"
"139",18,"18",11,"Prosocial","crossroad",8,6,8,1,2,2,1,2,3,2,"younger","1","1"
"140",18,"18",12,"Prosocial","volunteer",10,8,9,2,2,1,0,2,3,2,"younger","1","1"
"141",19,"19",1,"Antisocial","late",3,5,4,2,2,-1,0,-2,4,2,"younger","1","0"
"142",19,"19",2,"Prosocial","lendMoney",9,7,7,1,5,0,4,2,4,2,"younger","1","1"
"143",19,"19",5,"Prosocial","queue",9,7,7,4,5,0,1,2,4,2,"younger","1","1"
"144",19,"19",7,"Antisocial","download",4,6,5,4,4,-1,0,-2,4,2,"younger","1","0"
"145",19,"19",8,"Antisocial","distance",9,11,10,6,6,-1,0,-2,4,2,"younger","1","0"
"146",19,"19",10,"Prosocial","homeless",10,8,8,2,4,0,2,2,4,2,"younger","1","1"
"147",19,"19",11,"Antisocial","chargers",7,9,6,7,5,-3,-2,-2,4,2,"younger","1","0"
"148",19,"19",12,"Prosocial","screentime",10,8,7,1,3,-1,2,2,4,2,"younger","1","1"
"149",20,"20",2,"Prosocial","organicVegetables",8,6,7,3,4,1,1,2,6,1,"younger","1","1"
"150",20,"20",4,"Antisocial","distance",2,4,1,7,1,-3,-6,-2,6,1,"younger","1","0"
"151",20,"20",5,"Antisocial","shower",6,8,7,6,4,-1,-2,-2,6,1,"younger","1","0"
"152",20,"20",6,"Prosocial","crossroad",11,9,9,5,6,0,1,2,6,1,"younger","1","1"
"153",20,"20",9,"Prosocial","charity",10,8,11,6,7,3,1,2,6,1,"younger","1","1"
"154",20,"20",10,"Antisocial","chargers",7,9,6,6,4,-3,-2,-2,6,1,"younger","1","0"
"155",20,"20",11,"Antisocial","heating",4,6,6,3,4,0,1,-2,6,1,"younger","1","0"
"156",20,"20",12,"Prosocial","seatBus",11,9,11,6,5,2,-1,2,6,1,"younger","1","1"
"157",21,"21",1,"Antisocial","distance",1,3,1,2,2,-2,0,-2,2,1,"younger","1","0"
"158",21,"21",2,"Antisocial","download",3,5,6,5,5,1,0,-2,2,1,"younger","1","0"
"159",21,"21",4,"Antisocial","chargers",2,4,5,6,6,1,0,-2,2,1,"younger","1","0"
"160",21,"21",5,"Prosocial","homeless",9,7,6,1,2,-1,1,2,2,1,"younger","1","1"
"161",21,"21",6,"Prosocial","washands",10,8,8,5,5,0,0,2,2,1,"younger","1","1"
"162",21,"21",9,"Prosocial","ownbag",9,7,6,4,4,-1,0,2,2,1,"younger","1","1"
"163",21,"21",10,"Prosocial","speed",10,8,6,5,4,-2,-1,2,2,1,"younger","1","1"
"164",21,"21",12,"Antisocial","coughelbow",3,5,5,2,3,0,1,-2,2,1,"younger","1","0"
"165",22,"22",1,"Antisocial","coughelbow",2,4,3,3,2,-1,-1,-2,4,1,"younger","1","0"
"166",22,"22",3,"Prosocial","speed",8,6,9,3,5,3,2,2,4,1,"younger","1","1"
"167",22,"22",6,"Prosocial","volunteer",8,6,9,2,4,3,2,2,4,1,"younger","1","1"
"168",22,"22",7,"Antisocial","chargers",4,6,4,7,3,-2,-4,-2,4,1,"younger","1","0"
"169",22,"22",8,"Prosocial","ownbag",10,8,11,6,7,3,1,2,4,1,"younger","1","1"
"170",22,"22",10,"Antisocial","download",4,6,4,3,4,-2,1,-2,4,1,"younger","1","0"
"171",22,"22",11,"Antisocial","distance",3,5,3,3,2,-2,-1,-2,4,1,"younger","1","0"
"172",23,"23",1,"Prosocial","organicVegetables",9,7,7,1,1,0,0,2,1,2,"younger","1","1"
"173",23,"23",2,"Antisocial","coughelbow",6,8,11,5,1,3,-4,-2,1,2,"younger","1","0"
"174",23,"23",6,"Antisocial","lights",4,6,2,2,1,-4,-1,-2,1,2,"younger","1","0"
"175",23,"23",8,"Prosocial","vegetarian",7,5,1,1,4,-4,3,2,1,2,"younger","1","1"
"176",23,"23",9,"Prosocial","sustainable",9,7,7,4,4,0,0,2,1,2,"younger","1","1"
"177",23,"23",10,"Prosocial","washands",11,9,11,4,2,2,-2,2,1,2,"younger","1","1"
"178",23,"23",11,"Antisocial","cyberbully",3,5,2,2,1,-3,-1,-2,1,2,"younger","1","0"
"179",23,"23",12,"Antisocial","shower",2,4,3,5,3,-1,-2,-2,1,2,"younger","1","0"
"180",24,"24",2,"Antisocial","lights",3,5,5,4,4,0,0,-2,6,2,"younger","1","0"
"181",24,"24",4,"Antisocial","distance",4,6,5,7,6,-1,-1,-2,6,2,"younger","1","0"
"182",24,"24",5,"Prosocial","screentime",8,6,8,2,2,2,0,2,6,2,"younger","1","1"
"183",24,"24",6,"Prosocial","volunteer",10,8,11,1,2,3,1,2,6,2,"younger","1","1"
"184",24,"24",7,"Prosocial","organicVegetables",9,7,8,2,3,1,1,2,6,2,"younger","1","1"
"185",24,"24",8,"Antisocial","gathering",3,5,2,3,3,-3,0,-2,6,2,"younger","1","0"
"186",24,"24",10,"Prosocial","bike",11,9,11,1,4,2,3,2,6,2,"younger","1","1"
"187",24,"24",12,"Antisocial","chargers",4,6,6,7,7,0,0,-2,6,2,"younger","1","0"
"188",25,"25",1,"Antisocial","download",1,4,4,4,6,0,2,-3,5,2,"younger","1","0"
"189",25,"25",2,"Prosocial","organicVegetables",11,9,10,6,6,1,0,2,5,2,"younger","1","1"
"190",25,"25",3,"Antisocial","gathering",1,2,1,1,1,-1,0,-1,5,2,"younger","1","0"
"191",25,"25",5,"Prosocial","vegetarian",9,7,10,4,2,3,-2,2,5,2,"younger","1","1"
"192",25,"25",8,"Antisocial","lights",1,3,1,1,2,-2,1,-2,5,2,"younger","1","0"
"193",25,"25",9,"Prosocial","speed",10,8,11,5,5,3,0,2,5,2,"younger","1","1"
"194",25,"25",10,"Prosocial","bike",8,6,9,4,2,3,-2,2,5,2,"younger","1","1"
"195",25,"25",11,"Antisocial","redlights",2,4,3,2,1,-1,-1,-2,5,2,"younger","1","0"
"196",26,"26",2,"Prosocial","organicVegetables",9,7,6,3,6,-1,3,2,5,2,"younger","1","1"
"197",26,"26",3,"Antisocial","coughelbow",2,4,1,2,4,-3,2,-2,5,2,"younger","1","0"
"198",26,"26",5,"Prosocial","ownbag",9,7,7,4,5,0,1,2,5,2,"younger","1","1"
"199",26,"26",6,"Prosocial","speed",8,6,7,4,5,1,1,2,5,2,"younger","1","1"
"200",26,"26",7,"Prosocial","queue",8,6,6,4,5,0,1,2,5,2,"younger","1","1"
"201",26,"26",8,"Antisocial","gathering",6,8,7,5,5,-1,0,-2,5,2,"younger","1","0"
"202",26,"26",9,"Antisocial","shower",4,6,6,5,5,0,0,-2,5,2,"younger","1","0"
"203",26,"26",12,"Antisocial","chargers",4,6,7,7,5,1,-2,-2,5,2,"younger","1","0"
"204",27,"27",1,"Antisocial","download",1,3,7,5,7,4,2,-2,4,1,"younger","1","0"
"205",27,"27",2,"Antisocial","lights",4,6,8,5,6,2,1,-2,4,1,"younger","1","0"
"206",27,"27",3,"Prosocial","homeless",10,8,8,4,3,0,-1,2,4,1,"younger","1","1"
"207",27,"27",4,"Prosocial","queue",9,7,4,5,2,-3,-3,2,4,1,"younger","1","1"
"208",27,"27",7,"Prosocial","bike",9,7,11,1,1,4,0,2,4,1,"younger","1","1"
"209",27,"27",10,"Prosocial","vegetarian",6,4,7,1,2,3,1,2,4,1,"younger","1","1"
"210",27,"27",11,"Antisocial","meat",8,10,10,7,7,0,0,-2,4,1,"younger","1","0"
"211",27,"27",12,"Antisocial","chargers",1,3,2,6,6,-1,0,-2,4,1,"younger","1","0"
"212",28,"28",1,"Prosocial","organicVegetables",8,6,5,4,3,-1,-1,2,5,2,"younger","1","1"
"213",28,"28",4,"Prosocial","bike",8,6,6,1,4,0,3,2,5,2,"younger","1","1"
"214",28,"28",5,"Antisocial","distance",2,4,3,6,3,-1,-3,-2,5,2,"younger","1","0"
"215",28,"28",8,"Antisocial","meat",6,8,11,7,7,3,0,-2,5,2,"younger","1","0"
"216",28,"28",9,"Antisocial","gathering",4,6,4,2,5,-2,3,-2,5,2,"younger","1","0"
"217",28,"28",10,"Antisocial","chargers",7,9,11,7,6,2,-1,-2,5,2,"younger","1","0"
"218",28,"28",12,"Prosocial","homeless",11,9,9,4,6,0,2,2,5,2,"younger","1","1"
"219",29,"29",1,"Antisocial","heating",3,5,5,4,4,0,0,-2,2,1,"younger","1","0"
"220",29,"29",4,"Antisocial","shower",4,6,8,7,4,2,-3,-2,2,1,"younger","1","0"
"221",29,"29",5,"Prosocial","sustainable",9,7,9,4,4,2,0,2,2,1,"younger","1","1"
"222",29,"29",8,"Prosocial","charity",10,8,9,2,5,1,3,2,2,1,"younger","1","1"
"223",29,"29",9,"Antisocial","lights",3,5,8,5,5,3,0,-2,2,1,"younger","1","0"
"224",29,"29",10,"Prosocial","homeless",9,7,11,1,3,4,2,2,2,1,"younger","1","1"
"225",29,"29",11,"Antisocial","chargers",3,5,7,7,6,2,-1,-2,2,1,"younger","1","0"
"226",29,"29",12,"Prosocial","vegetarian",8,6,5,1,3,-1,2,2,2,1,"younger","1","1"
"227",30,"30",1,"Antisocial","heating",4,6,5,2,1,-1,-1,-2,3,1,"younger","1","0"
"228",30,"30",3,"Antisocial","redlights",1,3,1,2,1,-2,-1,-2,3,1,"younger","1","0"
"229",30,"30",4,"Antisocial","lights",3,5,5,4,1,0,-3,-2,3,1,"younger","1","0"
"230",30,"30",5,"Prosocial","queue",10,8,9,4,5,1,1,2,3,1,"younger","1","1"
"231",30,"30",6,"Prosocial","homeless",11,9,11,4,6,2,2,2,3,1,"younger","1","1"
"232",30,"30",10,"Prosocial","volunteer",11,9,11,3,4,2,1,2,3,1,"younger","1","1"
"233",30,"30",11,"Prosocial","charity",11,9,11,4,5,2,1,2,3,1,"younger","1","1"
"234",30,"30",12,"Antisocial","parking",2,4,2,2,1,-2,-1,-2,3,1,"younger","1","0"
"235",31,"31",1,"Prosocial","speed",8,6,7,4,4,1,0,2,6,1,"younger","1","1"
"236",31,"31",2,"Prosocial","bike",11,9,11,1,1,2,0,2,6,1,"younger","1","1"
"237",31,"31",3,"Antisocial","shower",4,6,4,7,6,-2,-1,-2,6,1,"younger","1","0"
"238",31,"31",5,"Antisocial","lights",6,8,5,5,6,-3,1,-2,6,1,"younger","1","0"
"239",31,"31",6,"Prosocial","crossroad",10,8,11,2,2,3,0,2,6,1,"younger","1","1"
"240",31,"31",10,"Antisocial","download",4,6,6,4,5,0,1,-2,6,1,"younger","1","0"
"241",31,"31",11,"Antisocial","chargers",6,8,6,7,7,-2,0,-2,6,1,"younger","1","0"
"242",31,"31",12,"Prosocial","screentime",8,6,4,1,2,-2,1,2,6,1,"younger","1","1"
"243",32,"32",1,"Antisocial","lights",4,6,6,6,6,0,0,-2,3,1,"younger","1","0"
"244",32,"32",2,"Prosocial","organicVegetables",6,4,4,1,2,0,1,2,3,1,"younger","1","1"
"245",32,"32",4,"Prosocial","speed",8,6,8,1,2,2,1,2,3,1,"younger","1","1"
"246",32,"32",7,"Antisocial","cyberbully",4,6,5,5,3,-1,-2,-2,3,1,"younger","1","0"
"247",32,"32",9,"Prosocial","homeless",8,6,6,1,1,0,0,2,3,1,"younger","1","1"
"248",32,"32",10,"Prosocial","vegetarian",7,5,4,1,1,-1,0,2,3,1,"younger","1","1"
"249",32,"32",11,"Antisocial","chargers",4,6,6,7,6,0,-1,-2,3,1,"younger","1","0"
"250",32,"32",12,"Antisocial","distance",4,6,6,6,4,0,-2,-2,3,1,"younger","1","0"
"251",33,"33",1,"Antisocial","meat",8,10,10,7,6,0,-1,-2,3,2,"younger","1","0"
"252",33,"33",4,"Antisocial","travelticket",4,6,6,3,1,0,-2,-2,3,2,"younger","1","0"
"253",33,"33",6,"Prosocial","organicVegetables",11,9,9,5,6,0,1,2,3,2,"younger","1","1"
"254",33,"33",7,"Prosocial","homeless",7,5,8,5,5,3,0,2,3,2,"younger","1","1"
"255",33,"33",9,"Antisocial","distance",1,3,1,5,1,-2,-4,-2,3,2,"younger","1","0"
"256",33,"33",10,"Prosocial","queue",5,3,2,3,2,-1,-1,2,3,2,"younger","1","1"
"257",33,"33",11,"Antisocial","shower",8,10,8,7,6,-2,-1,-2,3,2,"younger","1","0"
"258",33,"33",12,"Prosocial","volunteer",11,9,7,3,6,-2,3,2,3,2,"younger","1","1"
"259",34,"34",2,"Antisocial","chargers",1,3,6,4,4,3,0,-2,1,1,"younger","1","0"
"260",34,"34",3,"Prosocial","ownbag",8,6,6,4,4,0,0,2,1,1,"younger","1","1"
"261",34,"34",5,"Antisocial","gathering",2,4,1,5,1,-3,-4,-2,1,1,"younger","1","0"
"262",34,"34",7,"Prosocial","bike",9,7,6,3,4,-1,1,2,1,1,"younger","1","1"
"263",34,"34",8,"Antisocial","download",4,6,6,4,4,0,0,-2,1,1,"younger","1","0"
"264",34,"34",10,"Prosocial","queue",6,4,6,5,4,2,-1,2,1,1,"younger","1","1"
"265",34,"34",11,"Prosocial","screentime",8,6,6,4,4,0,0,2,1,1,"younger","1","1"
"266",34,"34",12,"Antisocial","travelticket",4,6,6,4,4,0,0,-2,1,1,"younger","1","0"
"267",35,"35",7,"Prosocial","homeless",8,6,9,4,5,3,1,2,3,1,"younger","1","1"
"268",35,"35",8,"Prosocial","speed",7,5,6,2,5,1,3,2,3,1,"younger","1","1"
"269",35,"35",10,"Prosocial","queue",8,6,8,5,6,2,1,2,3,1,"younger","1","1"
"270",35,"35",12,"Prosocial","vegetarian",9,7,9,2,6,2,4,2,3,1,"younger","1","1"
"271",36,"36",1,"Antisocial","heating",1,3,1,1,1,-2,0,-2,2,2,"younger","1","0"
"272",36,"36",3,"Prosocial","lendMoney",8,6,7,2,3,1,1,2,2,2,"younger","1","1"
"273",36,"36",4,"Antisocial","distance",1,3,1,7,3,-2,-4,-2,2,2,"younger","1","0"
"274",36,"36",6,"Prosocial","queue",8,6,7,2,5,1,3,2,2,2,"younger","1","1"
"275",36,"36",7,"Antisocial","gathering",3,5,3,2,2,-2,0,-2,2,2,"younger","1","0"
"276",36,"36",9,"Prosocial","screentime",10,8,10,2,4,2,2,2,2,2,"younger","1","1"
"277",36,"36",10,"Prosocial","organicVegetables",9,7,6,1,3,-1,2,2,2,2,"younger","1","1"
"278",36,"36",11,"Antisocial","meat",6,8,6,7,7,-2,0,-2,2,2,"younger","1","0"
"279",36,"36",12,"Antisocial","chargers",4,6,4,6,4,-2,-2,-2,2,2,"younger","1","0"
"280",37,"37",2,"Prosocial","bike",11,9,9,1,4,0,3,2,4,1,"younger","1","1"
"281",37,"37",3,"Antisocial","cyberbully",2,4,2,2,1,-2,-1,-2,4,1,"younger","1","0"
"282",37,"37",4,"Antisocial","chargers",2,4,1,5,2,-3,-3,-2,4,1,"younger","1","0"
"283",37,"37",6,"Antisocial","download",4,6,6,4,4,0,0,-2,4,1,"younger","1","0"
"284",37,"37",7,"Antisocial","distance",8,10,11,7,7,1,0,-2,4,1,"younger","1","0"
"285",37,"37",9,"Prosocial","homeless",8,6,6,1,4,0,3,2,4,1,"younger","1","1"
"286",37,"37",10,"Prosocial","charity",11,9,10,1,5,1,4,2,4,1,"younger","1","1"
"287",37,"37",11,"Prosocial","vegetarian",6,4,6,1,4,2,3,2,4,1,"younger","1","1"
"288",38,"38",1,"Prosocial","vegetarian",9,7,9,3,4,2,1,2,3,1,"younger","1","1"
"289",38,"38",3,"Prosocial","homeless",10,8,9,2,5,1,3,2,3,1,"younger","1","1"
"290",38,"38",4,"Prosocial","volunteer",10,8,10,5,6,2,1,2,3,1,"younger","1","1"
"291",38,"38",5,"Prosocial","recycle",10,8,11,4,7,3,3,2,3,1,"younger","1","1"
"292",38,"38",6,"Antisocial","shower",2,4,2,2,2,-2,0,-2,3,1,"younger","1","0"
"293",38,"38",7,"Antisocial","download",3,5,3,4,3,-2,-1,-2,3,1,"younger","1","0"
"294",38,"38",9,"Antisocial","late",2,4,2,5,2,-2,-3,-2,3,1,"younger","1","0"
"295",38,"38",10,"Antisocial","coughelbow",6,8,3,4,2,-5,-2,-2,3,1,"younger","1","0"
"296",39,"39",1,"Prosocial","volunteer",11,9,11,5,6,2,1,2,6,2,"younger","1","1"
"297",39,"39",2,"Prosocial","queue",4,2,6,2,2,4,0,2,6,2,"younger","1","1"
"298",39,"39",5,"Prosocial","charity",11,9,11,6,7,2,1,2,6,2,"younger","1","1"
"299",39,"39",6,"Antisocial","shower",3,5,2,3,2,-3,-1,-2,6,2,"younger","1","0"
"300",39,"39",7,"Antisocial","heating",4,6,1,2,1,-5,-1,-2,6,2,"younger","1","0"
"301",39,"39",11,"Antisocial","chargers",4,6,2,6,5,-4,-1,-2,6,2,"younger","1","0"
"302",39,"39",12,"Antisocial","late",1,3,3,2,1,0,-1,-2,6,2,"younger","1","0"
"303",40,"40",2,"Antisocial","shower",6,8,5,7,7,-3,0,-2,4,1,"younger","1","0"
"304",40,"40",5,"Antisocial","download",3,5,4,2,2,-1,0,-2,4,1,"younger","1","0"
"305",40,"40",7,"Antisocial","chargers",4,6,7,7,6,1,-1,-2,4,1,"younger","1","0"
"306",40,"40",8,"Antisocial","redlights",1,2,1,1,1,-1,0,-1,4,1,"younger","1","0"
"307",40,"40",9,"Prosocial","screentime",10,8,9,3,6,1,3,2,4,1,"younger","1","1"
"308",40,"40",11,"Prosocial","bike",11,9,10,2,4,1,2,2,4,1,"younger","1","1"
"309",40,"40",12,"Prosocial","organicVegetables",11,9,9,6,7,0,1,2,4,1,"younger","1","1"
"310",41,"41",1,"Prosocial","seatBus",10,8,5,5,6,-3,1,2,4,2,"younger","1","1"
"311",41,"41",2,"Prosocial","queue",9,7,9,4,5,2,1,2,4,2,"younger","1","1"
"312",41,"41",4,"Antisocial","meat",6,8,11,7,7,3,0,-2,4,2,"younger","1","0"
"313",41,"41",5,"Prosocial","speed",10,8,7,6,4,-1,-2,2,4,2,"younger","1","1"
"314",41,"41",6,"Antisocial","travelticket",6,8,8,2,1,0,-1,-2,4,2,"younger","1","0"
"315",41,"41",7,"Antisocial","cyberbully",2,4,6,5,3,2,-2,-2,4,2,"younger","1","0"
"316",41,"41",9,"Antisocial","chargers",9,11,9,7,5,-2,-2,-2,4,2,"younger","1","0"
"317",41,"41",10,"Prosocial","bike",10,8,7,1,1,-1,0,2,4,2,"younger","1","1"
"318",42,"42",1,"Antisocial","noisedisturbance",2,4,3,2,1,-1,-1,-2,2,1,"younger","1","0"
"319",42,"42",2,"Prosocial","screentime",8,6,6,2,2,0,0,2,2,1,"younger","1","1"
"320",42,"42",4,"Antisocial","download",4,6,6,3,3,0,0,-2,2,1,"younger","1","0"
"321",42,"42",5,"Antisocial","lights",3,5,4,2,1,-1,-1,-2,2,1,"younger","1","0"
"322",42,"42",7,"Prosocial","homeless",10,8,11,1,1,3,0,2,2,1,"younger","1","1"
"323",42,"42",8,"Prosocial","charity",10,8,11,1,1,3,0,2,2,1,"younger","1","1"
"324",42,"42",9,"Antisocial","distance",3,5,5,4,3,0,-1,-2,2,1,"younger","1","0"
"325",42,"42",11,"Prosocial","crossroad",11,9,11,1,1,2,0,2,2,1,"younger","1","1"
"326",43,"43",1,"Antisocial","download",8,10,10,6,6,0,0,-2,6,2,"younger","1","0"
"327",43,"43",2,"Prosocial","vegetarian",8,6,6,2,2,0,0,2,6,2,"younger","1","1"
"328",43,"43",4,"Prosocial","crossroad",9,7,11,1,1,4,0,2,6,2,"younger","1","1"
"329",43,"43",6,"Prosocial","sustainable",10,8,8,3,4,0,1,2,6,2,"younger","1","1"
"330",43,"43",7,"Prosocial","volunteer",10,8,10,1,1,2,0,2,6,2,"younger","1","1"
"331",43,"43",9,"Antisocial","shower",4,6,6,7,5,0,-2,-2,6,2,"younger","1","0"
"332",43,"43",11,"Antisocial","meat",7,9,6,7,7,-3,0,-2,6,2,"younger","1","0"
"333",43,"43",12,"Antisocial","cyberbully",3,5,1,2,1,-4,-1,-2,6,2,"younger","1","0"
"334",44,"44",1,"Prosocial","homeless",9,7,10,2,6,3,4,2,5,2,"younger","1","1"
"335",44,"44",2,"Prosocial","crossroad",9,7,10,2,6,3,4,2,5,2,"younger","1","1"
"336",44,"44",4,"Prosocial","vegetarian",8,6,6,3,5,0,2,2,5,2,"younger","1","1"
"337",44,"44",5,"Prosocial","lendMoney",8,6,6,4,4,0,0,2,5,2,"younger","1","1"
"338",44,"44",6,"Antisocial","redlights",3,5,2,3,2,-3,-1,-2,5,2,"younger","1","0"
"339",44,"44",9,"Antisocial","lights",4,6,4,2,3,-2,1,-2,5,2,"younger","1","0"
"340",44,"44",10,"Antisocial","garbage",3,5,2,3,3,-3,0,-2,5,2,"younger","1","0"
"341",44,"44",12,"Antisocial","coughelbow",3,5,2,2,3,-3,1,-2,5,2,"younger","1","0"
"342",45,"45",2,"Prosocial","screentime",8,6,7,4,4,1,0,2,3,1,"younger","1","1"
"343",45,"45",3,"Antisocial","lights",4,6,5,4,3,-1,-1,-2,3,1,"younger","1","0"
"344",45,"45",4,"Antisocial","download",4,6,6,3,5,0,2,-2,3,1,"younger","1","0"
"345",45,"45",6,"Prosocial","queue",10,8,11,4,6,3,2,2,3,1,"younger","1","1"
"346",45,"45",7,"Prosocial","homeless",10,8,10,5,7,2,2,2,3,1,"younger","1","1"
"347",45,"45",9,"Antisocial","coughelbow",4,6,3,2,2,-3,0,-2,3,1,"younger","1","0"
"348",45,"45",10,"Prosocial","ownbag",10,8,11,4,6,3,2,2,3,1,"younger","1","1"
"349",45,"45",12,"Antisocial","redlights",4,6,1,3,6,-5,3,-2,3,1,"younger","1","0"
"350",46,"46",1,"Prosocial","crossroad",11,9,10,2,4,1,2,2,4,2,"younger","1","1"
"351",46,"46",3,"Antisocial","chargers",5,7,5,6,6,-2,0,-2,4,2,"younger","1","0"
"352",46,"46",5,"Prosocial","lendMoney",8,6,6,2,1,0,-1,2,4,2,"younger","1","1"
"353",46,"46",6,"Antisocial","alcoholWork",4,6,6,4,5,0,1,-2,4,2,"younger","1","0"
"354",46,"46",8,"Prosocial","queue",11,9,9,4,3,0,-1,2,4,2,"younger","1","1"
"355",46,"46",9,"Antisocial","shower",5,7,6,6,6,-1,0,-2,4,2,"younger","1","0"
"356",46,"46",10,"Antisocial","late",3,5,5,2,1,0,-1,-2,4,2,"younger","1","0"
"357",46,"46",12,"Prosocial","seatBus",10,8,10,3,1,2,-2,2,4,2,"younger","1","1"
"358",47,"47",1,"Antisocial","late",4,6,3,3,6,-3,3,-2,4,1,"younger","1","0"
"359",47,"47",2,"Antisocial","distance",4,6,2,4,7,-4,3,-2,4,1,"younger","1","0"
"360",47,"47",4,"Prosocial","lendMoney",8,6,3,2,6,-3,4,2,4,1,"younger","1","1"
"361",47,"47",5,"Prosocial","organicVegetables",6,4,9,3,2,5,-1,2,4,1,"younger","1","1"
"362",47,"47",8,"Antisocial","chargers",8,10,11,7,2,1,-5,-2,4,1,"younger","1","0"
"363",47,"47",9,"Prosocial","homeless",8,6,2,1,6,-4,5,2,4,1,"younger","1","1"
"364",47,"47",11,"Antisocial","meat",7,9,10,7,1,1,-6,-2,4,1,"younger","1","0"
"365",47,"47",12,"Prosocial","bike",8,6,11,2,1,5,-1,2,4,1,"younger","1","1"
"366",48,"48",1,"Antisocial","chargers",2,4,6,7,7,2,0,-2,4,1,"younger","1","0"
"367",48,"48",3,"Antisocial","lights",3,5,4,3,3,-1,0,-2,4,1,"younger","1","0"
"368",48,"48",4,"Prosocial","crossroad",10,8,11,5,4,3,-1,2,4,1,"younger","1","1"
"369",48,"48",6,"Antisocial","distance",3,5,4,4,4,-1,0,-2,4,1,"younger","1","0"
"370",48,"48",9,"Prosocial","vegetarian",11,9,9,5,1,0,-4,2,4,1,"younger","1","1"
"371",48,"48",11,"Prosocial","charity",10,8,11,5,6,3,1,2,4,1,"younger","1","1"
"372",48,"48",12,"Antisocial","alcoholWork",1,3,1,2,1,-2,-1,-2,4,1,"younger","1","0"
"373",49,"49",1,"Antisocial","shower",5,7,7,5,7,0,2,-2,4,1,"younger","1","0"
"374",49,"49",2,"Prosocial","homeless",11,9,11,2,7,2,5,2,4,1,"younger","1","1"
"375",49,"49",3,"Prosocial","lendMoney",9,7,9,1,7,2,6,2,4,1,"younger","1","1"
"376",49,"49",4,"Prosocial","washands",10,8,11,5,7,3,2,2,4,1,"younger","1","1"
"377",49,"49",7,"Prosocial","vegetarian",8,6,9,2,6,3,4,2,4,1,"younger","1","1"
"378",49,"49",8,"Antisocial","meat",6,8,8,7,7,0,0,-2,4,1,"younger","1","0"
"379",49,"49",9,"Antisocial","chargers",5,7,6,4,4,-1,0,-2,4,1,"younger","1","0"
"380",49,"49",11,"Antisocial","download",4,6,5,4,5,-1,1,-2,4,1,"younger","1","0"
"381",50,"50",1,"Antisocial","meat",7,9,8,7,7,-1,0,-2,5,2,"younger","1","0"
"382",50,"50",2,"Prosocial","lendMoney",8,6,9,1,3,3,2,2,5,2,"younger","1","1"
"383",50,"50",4,"Prosocial","homeless",11,9,11,2,3,2,1,2,5,2,"younger","1","1"
"384",50,"50",5,"Prosocial","queue",7,5,8,2,5,3,3,2,5,2,"younger","1","1"
"385",50,"50",7,"Antisocial","download",6,8,9,6,7,1,1,-2,5,2,"younger","1","0"
"386",50,"50",11,"Antisocial","chargers",6,8,6,7,7,-2,0,-2,5,2,"younger","1","0"
"387",50,"50",12,"Antisocial","shower",5,7,6,6,4,-1,-2,-2,5,2,"younger","1","0"
"388",51,"51",1,"Prosocial","speed",10,8,9,2,7,1,5,2,5,2,"younger","1","1"
"389",51,"51",2,"Prosocial","organicVegetables",11,9,11,4,7,2,3,2,5,2,"younger","1","1"
"390",51,"51",4,"Antisocial","chargers",6,8,9,7,7,1,0,-2,5,2,"younger","1","0"
"391",51,"51",5,"Antisocial","noisedisturbance",3,5,4,5,3,-1,-2,-2,5,2,"younger","1","0"
"392",51,"51",7,"Antisocial","shower",5,7,7,5,5,0,0,-2,5,2,"younger","1","0"
"393",51,"51",8,"Prosocial","vegetarian",10,8,11,1,7,3,6,2,5,2,"younger","1","1"
"394",51,"51",11,"Antisocial","meat",7,9,9,7,7,0,0,-2,5,2,"younger","1","0"
"395",51,"51",12,"Prosocial","homeless",11,9,11,1,6,2,5,2,5,2,"younger","1","1"
"396",52,"52",1,"Antisocial","meat",8,10,9,7,5,-1,-2,-2,4,1,"younger","1","0"
"397",52,"52",2,"Prosocial","washands",10,8,10,5,7,2,2,2,4,1,"younger","1","1"
"398",52,"52",3,"Antisocial","shower",7,9,7,5,4,-2,-1,-2,4,1,"younger","1","0"
"399",52,"52",9,"Antisocial","chargers",2,4,4,6,3,0,-3,-2,4,1,"younger","1","0"
"400",52,"52",12,"Prosocial","vegetarian",8,6,8,4,5,2,1,2,4,1,"younger","1","1"
"401",53,"53",1,"Antisocial","garbage",1,3,1,5,1,-2,-4,-2,3,1,"younger","1","0"
"402",53,"53",3,"Prosocial","vegetarian",8,6,6,1,1,0,0,2,3,1,"younger","1","1"
"403",53,"53",4,"Prosocial","lendMoney",8,6,6,1,1,0,0,2,3,1,"younger","1","1"
"404",53,"53",5,"Antisocial","shower",4,6,1,5,4,-5,-1,-2,3,1,"younger","1","0"
"405",53,"53",6,"Antisocial","lights",1,3,1,7,7,-2,0,-2,3,1,"younger","1","0"
"406",53,"53",7,"Prosocial","sustainable",8,6,11,1,1,5,0,2,3,1,"younger","1","1"
"407",53,"53",10,"Antisocial","noisedisturbance",1,3,1,7,7,-2,0,-2,3,1,"younger","1","0"
"408",53,"53",11,"Prosocial","homeless",8,6,6,1,1,0,0,2,3,1,"younger","1","1"
"409",54,"54",1,"Prosocial","lendMoney",9,7,8,4,5,1,1,2,4,2,"younger","1","1"
"410",54,"54",2,"Antisocial","distance",8,10,4,7,2,-6,-5,-2,4,2,"younger","1","0"
"411",54,"54",4,"Antisocial","redlights",2,4,6,6,4,2,-2,-2,4,2,"younger","1","0"
"412",54,"54",7,"Antisocial","late",4,6,5,5,3,-1,-2,-2,4,2,"younger","1","0"
"413",54,"54",9,"Antisocial","chargers",4,6,6,7,7,0,0,-2,4,2,"younger","1","0"
"414",54,"54",11,"Prosocial","homeless",10,8,8,4,2,0,-2,2,4,2,"younger","1","1"
"415",54,"54",12,"Prosocial","bike",8,6,6,5,1,0,-4,2,4,2,"younger","1","1"
"416",55,"55",1,"Prosocial","seatBus",10,8,10,2,6,2,4,2,3,2,"younger","1","1"
"417",55,"55",2,"Antisocial","distance",5,7,7,6,5,0,-1,-2,3,2,"younger","1","0"
"418",55,"55",3,"Prosocial","lendMoney",9,7,7,1,4,0,3,2,3,2,"younger","1","1"
"419",55,"55",6,"Prosocial","homeless",6,4,3,1,3,-1,2,2,3,2,"younger","1","1"
"420",55,"55",7,"Antisocial","shower",3,5,6,6,4,1,-2,-2,3,2,"younger","1","0"
"421",55,"55",8,"Prosocial","ownbag",10,8,10,6,6,2,0,2,3,2,"younger","1","1"
"422",55,"55",11,"Antisocial","chargers",7,9,7,5,6,-2,1,-2,3,2,"younger","1","0"
"423",55,"55",12,"Antisocial","late",2,4,2,2,2,-2,0,-2,3,2,"younger","1","0"
"424",56,"56",2,"Prosocial","recycle",9,7,7,6,5,0,-1,2,4,2,"younger","1","1"
"425",56,"56",5,"Prosocial","homeless",10,8,9,3,5,1,2,2,4,2,"younger","1","1"
"426",56,"56",6,"Antisocial","late",2,4,2,5,1,-2,-4,-2,4,2,"younger","1","0"
"427",56,"56",7,"Prosocial","lendMoney",8,6,6,6,5,0,-1,2,4,2,"younger","1","1"
"428",56,"56",8,"Antisocial","chargers",4,6,6,7,7,0,0,-2,4,2,"younger","1","0"
"429",56,"56",9,"Antisocial","garbage",1,3,1,2,3,-2,1,-2,4,2,"younger","1","0"
"430",56,"56",10,"Prosocial","crossroad",11,9,11,2,3,2,1,2,4,2,"younger","1","1"
"431",56,"56",12,"Antisocial","noisedisturbance",1,3,1,2,2,-2,0,-2,4,2,"younger","1","0"
"432",57,"57",2,"Prosocial","queue",6,4,4,1,3,0,2,2,3,2,"younger","1","1"
"433",57,"57",4,"Prosocial","screentime",8,6,6,6,4,0,-2,2,3,2,"younger","1","1"
"434",57,"57",5,"Antisocial","chargers",2,4,3,5,5,-1,0,-2,3,2,"younger","1","0"
"435",57,"57",7,"Prosocial","homeless",10,8,8,3,5,0,2,2,3,2,"younger","1","1"
"436",57,"57",9,"Antisocial","late",3,5,1,3,1,-4,-2,-2,3,2,"younger","1","0"
"437",57,"57",10,"Prosocial","organicVegetables",11,8,9,2,5,1,3,3,3,2,"younger","1","1"
"438",57,"57",12,"Antisocial","distance",9,11,10,6,7,-1,1,-2,3,2,"younger","1","0"
"439",58,"58",2,"Prosocial","queue",11,9,11,2,1,2,-1,2,3,1,"younger","1","1"
"440",58,"58",4,"Antisocial","meat",7,9,8,7,7,-1,0,-2,3,1,"younger","1","0"
"441",58,"58",5,"Prosocial","vegetarian",10,8,9,1,2,1,1,2,3,1,"younger","1","1"
"442",58,"58",7,"Antisocial","chargers",6,8,6,7,6,-2,-1,-2,3,1,"younger","1","0"
"443",58,"58",8,"Prosocial","homeless",9,7,7,1,1,0,0,2,3,1,"younger","1","1"
"444",58,"58",9,"Prosocial","lendMoney",9,7,8,2,2,1,0,2,3,1,"younger","1","1"
"445",58,"58",10,"Antisocial","redlights",4,6,2,5,4,-4,-1,-2,3,1,"younger","1","0"
"446",58,"58",11,"Antisocial","late",3,5,4,6,5,-1,-1,-2,3,1,"younger","1","0"
"447",59,"59",1,"Prosocial","ownbag",8,6,5,3,3,-1,0,2,4,1,"younger","1","1"
"448",59,"59",2,"Prosocial","seatBus",8,6,5,4,3,-1,-1,2,4,1,"younger","1","1"
"449",59,"59",4,"Prosocial","recycle",8,6,7,6,5,1,-1,2,4,1,"younger","1","1"
"450",59,"59",5,"Antisocial","late",4,6,2,2,3,-4,1,-2,4,1,"younger","1","0"
"451",59,"59",6,"Antisocial","download",4,6,6,2,4,0,2,-2,4,1,"younger","1","0"
"452",59,"59",8,"Antisocial","meat",6,8,8,6,6,0,0,-2,4,1,"younger","1","0"
"453",59,"59",10,"Prosocial","speed",8,6,6,4,4,0,0,2,4,1,"younger","1","1"
"454",59,"59",11,"Antisocial","distance",4,6,6,5,4,0,-1,-2,4,1,"younger","1","0"
"455",60,"60",1,"Prosocial","bike",8,6,7,1,1,1,0,2,3,1,"younger","1","1"
"456",60,"60",2,"Prosocial","queue",7,5,5,4,1,0,-3,2,3,1,"younger","1","1"
"457",60,"60",3,"Antisocial","chargers",5,7,5,7,6,-2,-1,-2,3,1,"younger","1","0"
"458",60,"60",4,"Antisocial","shower",5,7,6,7,5,-1,-2,-2,3,1,"younger","1","0"
"459",60,"60",5,"Prosocial","lendMoney",7,5,7,5,5,2,0,2,3,1,"younger","1","1"
"460",60,"60",6,"Antisocial","late",3,5,4,5,4,-1,-1,-2,3,1,"younger","1","0"
"461",60,"60",8,"Antisocial","download",4,6,5,2,2,-1,0,-2,3,1,"younger","1","0"
"462",60,"60",10,"Prosocial","charity",10,8,9,2,3,1,1,2,3,1,"younger","1","1"
"463",61,"61",2,"Prosocial","lendMoney",8,6,7,3,4,1,1,2,5,1,"younger","1","1"
"464",61,"61",4,"Antisocial","lights",4,6,5,5,5,-1,0,-2,5,1,"younger","1","0"
"465",61,"61",5,"Antisocial","download",1,3,2,2,2,-1,0,-2,5,1,"younger","1","0"
"466",61,"61",6,"Prosocial","sustainable",10,8,11,4,5,3,1,2,5,1,"younger","1","1"
"467",61,"61",8,"Prosocial","screentime",8,6,7,1,4,1,3,2,5,1,"younger","1","1"
"468",61,"61",10,"Antisocial","shower",4,6,5,2,3,-1,1,-2,5,1,"younger","1","0"
"469",61,"61",11,"Antisocial","chargers",4,6,6,7,6,0,-1,-2,5,1,"younger","1","0"
"470",61,"61",12,"Prosocial","queue",11,9,10,4,5,1,1,2,5,1,"younger","1","1"
"471",62,"62",1,"Antisocial","download",4,6,7,3,4,1,1,-2,2,2,"younger","1","0"
"472",62,"62",2,"Prosocial","organicVegetables",11,8,11,4,7,3,3,3,2,2,"younger","1","1"
"473",62,"62",3,"Antisocial","distance",4,6,5,7,3,-1,-4,-2,2,2,"younger","1","0"
"474",62,"62",5,"Antisocial","chargers",4,6,6,6,5,0,-1,-2,2,2,"younger","1","0"
"475",63,"63",1,"Antisocial","coughelbow",1,2,1,2,1,-1,-1,-1,5,1,"younger","1","0"
"476",63,"63",3,"Prosocial","volunteer",10,8,11,4,5,3,1,2,5,1,"younger","1","1"
"477",63,"63",5,"Prosocial","queue",10,8,11,5,3,3,-2,2,5,1,"younger","1","1"
"478",63,"63",6,"Antisocial","chargers",2,4,6,7,7,2,0,-2,5,1,"younger","1","0"
"479",63,"63",7,"Antisocial","distance",1,2,3,6,7,1,1,-1,5,1,"younger","1","0"
"480",63,"63",8,"Prosocial","homeless",10,8,8,4,1,0,-3,2,5,1,"younger","1","1"
"481",63,"63",10,"Prosocial","vegetarian",8,6,6,1,1,0,0,2,5,1,"younger","1","1"
"482",63,"63",11,"Antisocial","noisedisturbance",3,6,1,2,5,-5,3,-3,5,1,"younger","1","0"
"483",64,"64",1,"Antisocial","heating",1,3,1,4,1,-2,-3,-2,1,1,"younger","1","0"
"484",64,"64",2,"Prosocial","homeless",8,6,7,1,2,1,1,2,1,1,"younger","1","1"
"485",64,"64",6,"Prosocial","queue",5,3,1,1,1,-2,0,2,1,1,"younger","1","1"
"486",64,"64",8,"Antisocial","distance",9,11,8,7,4,-3,-3,-2,1,1,"younger","1","0"
"487",64,"64",9,"Antisocial","download",7,9,11,7,7,2,0,-2,1,1,"younger","1","0"
"488",64,"64",10,"Antisocial","shower",2,4,4,5,5,0,0,-2,1,1,"younger","1","0"
"489",64,"64",11,"Prosocial","seatBus",11,9,6,1,2,-3,1,2,1,1,"younger","1","1"
"490",64,"64",12,"Prosocial","lendMoney",8,6,5,1,3,-1,2,2,1,1,"younger","1","1"
"491",65,"65",3,"Prosocial","lendMoney",4,2,4,6,5,2,-1,2,3,1,"younger","1","1"
"492",65,"65",4,"Antisocial","coughelbow",1,3,1,2,1,-2,-1,-2,3,1,"younger","1","0"
"493",65,"65",6,"Antisocial","chargers",9,11,3,6,2,-8,-4,-2,3,1,"younger","1","0"
"494",65,"65",7,"Antisocial","distance",1,3,10,2,5,7,3,-2,3,1,"younger","1","0"
"495",65,"65",8,"Prosocial","crossroad",11,9,10,6,7,1,1,2,3,1,"younger","1","1"
"496",65,"65",9,"Antisocial","meat",9,11,6,6,4,-5,-2,-2,3,1,"younger","1","0"
"497",65,"65",10,"Prosocial","speed",10,8,10,6,7,2,1,2,3,1,"younger","1","1"
"498",66,"66",1,"Antisocial","late",1,3,1,5,2,-2,-3,-2,5,1,"younger","1","0"
"499",66,"66",2,"Antisocial","noisedisturbance",1,3,1,5,3,-2,-2,-2,5,1,"younger","1","0"
"500",66,"66",3,"Prosocial","screentime",8,6,9,4,6,3,2,2,5,1,"younger","1","1"
"501",66,"66",4,"Antisocial","shower",4,6,4,5,5,-2,0,-2,5,1,"younger","1","0"
"502",66,"66",6,"Prosocial","queue",8,6,6,4,4,0,0,2,5,1,"younger","1","1"
"503",66,"66",7,"Antisocial","chargers",4,6,6,7,7,0,0,-2,5,1,"younger","1","0"
"504",66,"66",8,"Prosocial","homeless",8,6,6,3,5,0,2,2,5,1,"younger","1","1"
"505",66,"66",12,"Prosocial","organicVegetables",8,6,6,4,4,0,0,2,5,1,"younger","1","1"
"506",67,"67",1,"Prosocial","crossroad",11,9,11,1,1,2,0,2,4,1,"younger","1","1"
"507",67,"67",2,"Antisocial","chargers",2,4,5,7,7,1,0,-2,4,1,"younger","1","0"
"508",67,"67",3,"Antisocial","lights",3,5,4,7,1,-1,-6,-2,4,1,"younger","1","0"
"509",67,"67",6,"Prosocial","bike",10,8,9,1,3,1,2,2,4,1,"younger","1","1"
"510",67,"67",9,"Antisocial","distance",3,5,6,7,7,1,0,-2,4,1,"younger","1","0"
"511",67,"67",10,"Prosocial","screentime",8,6,6,1,1,0,0,2,4,1,"younger","1","1"
"512",67,"67",11,"Antisocial","late",1,3,2,2,2,-1,0,-2,4,1,"younger","1","0"
"513",67,"67",12,"Prosocial","queue",11,9,11,5,5,2,0,2,4,1,"younger","1","1"
"514",68,"68",2,"Antisocial","heating",5,7,3,2,2,-4,0,-2,4,1,"younger","1","0"
"515",68,"68",4,"Prosocial","homeless",11,9,6,4,5,-3,1,2,4,1,"younger","1","1"
"516",68,"68",5,"Antisocial","chargers",5,7,6,6,4,-1,-2,-2,4,1,"younger","1","0"
"517",68,"68",7,"Prosocial","organicVegetables",11,9,6,1,4,-3,3,2,4,1,"younger","1","1"
"518",68,"68",8,"Prosocial","lendMoney",9,7,8,2,5,1,3,2,4,1,"younger","1","1"
"519",68,"68",9,"Antisocial","cyberbully",2,4,2,5,1,-2,-4,-2,4,1,"younger","1","0"
"520",68,"68",10,"Prosocial","volunteer",10,8,9,5,7,1,2,2,4,1,"younger","1","1"
"521",68,"68",11,"Antisocial","gathering",7,9,6,5,4,-3,-1,-2,4,1,"younger","1","0"
"522",69,"69",1,"Antisocial","noisedisturbance",1,3,1,2,1,-2,-1,-2,6,1,"younger","1","0"
"523",69,"69",2,"Antisocial","meat",9,11,10,7,6,-1,-1,-2,6,1,"younger","1","0"
"524",69,"69",3,"Prosocial","ownbag",11,9,11,1,7,2,6,2,6,1,"younger","1","1"
"525",69,"69",6,"Antisocial","chargers",4,6,8,7,3,2,-4,-2,6,1,"younger","1","0"
"526",69,"69",7,"Antisocial","shower",8,11,10,7,7,-1,0,-3,6,1,"younger","1","0"
"527",69,"69",8,"Prosocial","seatBus",11,9,11,1,7,2,6,2,6,1,"younger","1","1"
"528",69,"69",10,"Prosocial","charity",11,9,11,1,6,2,5,2,6,1,"younger","1","1"
"529",69,"69",11,"Prosocial","sustainable",8,6,9,1,5,3,4,2,6,1,"younger","1","1"
"530",70,"70",4,"Prosocial","vegetarian",10,8,10,6,5,2,-1,2,5,1,"younger","1","1"
"531",70,"70",6,"Prosocial","bike",9,7,7,1,1,0,0,2,5,1,"younger","1","1"
"532",70,"70",7,"Antisocial","lights",2,4,5,3,2,1,-1,-2,5,1,"younger","1","0"
"533",70,"70",8,"Prosocial","ownbag",9,7,8,2,2,1,0,2,5,1,"younger","1","1"
"534",70,"70",9,"Prosocial","speed",9,7,8,3,4,1,1,2,5,1,"younger","1","1"
"535",70,"70",10,"Antisocial","shower",5,7,6,6,6,-1,0,-2,5,1,"younger","1","0"
"536",70,"70",11,"Antisocial","chargers",5,7,6,6,5,-1,-1,-2,5,1,"younger","1","0"
"537",70,"70",12,"Antisocial","heating",4,6,6,5,4,0,-1,-2,5,1,"younger","1","0"
"538",71,"71",1,"Prosocial","organicVegetables",8,6,6,4,5,0,1,2,6,2,"younger","1","1"
"539",71,"71",2,"Prosocial","crossroad",9,7,11,2,7,4,5,2,6,2,"younger","1","1"
"540",71,"71",3,"Antisocial","taxes",1,3,2,3,3,-1,0,-2,6,2,"younger","1","0"
"541",71,"71",5,"Prosocial","volunteer",11,9,10,5,3,1,-2,2,6,2,"younger","1","1"
"542",71,"71",7,"Antisocial","noisedisturbance",3,5,2,4,1,-3,-3,-2,6,2,"younger","1","0"
"543",71,"71",9,"Prosocial","queue",9,7,6,2,4,-1,2,2,6,2,"younger","1","1"
"544",71,"71",11,"Antisocial","coughelbow",1,3,2,3,2,-1,-1,-2,6,2,"younger","1","0"
"545",71,"71",12,"Antisocial","distance",8,10,10,6,6,0,0,-2,6,2,"younger","1","0"
"546",72,"72",1,"Prosocial","queue",8,6,2,1,2,-4,1,2,3,1,"younger","1","1"
"547",72,"72",2,"Antisocial","redlights",3,5,2,4,2,-3,-2,-2,3,1,"younger","1","0"
"548",72,"72",3,"Antisocial","meat",7,9,8,7,7,-1,0,-2,3,1,"younger","1","0"
"549",72,"72",5,"Prosocial","screentime",8,6,7,1,1,1,0,2,3,1,"younger","1","1"
"550",72,"72",6,"Antisocial","download",3,5,5,7,6,0,-1,-2,3,1,"younger","1","0"
"551",72,"72",8,"Antisocial","distance",3,5,3,7,5,-2,-2,-2,3,1,"younger","1","0"
"552",72,"72",9,"Prosocial","washands",9,7,11,1,2,4,1,2,3,1,"younger","1","1"
"553",72,"72",11,"Prosocial","seatBus",11,9,11,1,2,2,1,2,3,1,"younger","1","1"
"554",73,"73",1,"Prosocial","queue",10,8,10,6,5,2,-1,2,5,2,"younger","1","1"
"555",73,"73",2,"Prosocial","sustainable",11,9,10,3,5,1,2,2,5,2,"younger","1","1"
"556",73,"73",3,"Antisocial","shower",5,7,9,5,5,2,0,-2,5,2,"younger","1","0"
"557",73,"73",4,"Antisocial","heating",3,5,5,2,2,0,0,-2,5,2,"younger","1","0"
"558",73,"73",5,"Antisocial","noisedisturbance",3,5,6,5,3,1,-2,-2,5,2,"younger","1","0"
"559",73,"73",7,"Prosocial","ownbag",11,9,11,5,6,2,1,2,5,2,"younger","1","1"
"560",73,"73",9,"Antisocial","meat",7,9,9,6,7,0,1,-2,5,2,"younger","1","0"
"561",73,"73",11,"Prosocial","volunteer",11,9,11,4,6,2,2,2,5,2,"younger","1","1"
"562",74,"74",1,"Prosocial","charity",11,9,8,4,5,-1,1,2,6,2,"younger","1","1"
"563",74,"74",2,"Prosocial","ownbag",9,7,9,4,4,2,0,2,6,2,"younger","1","1"
"564",74,"74",4,"Prosocial","lendMoney",9,7,8,2,5,1,3,2,6,2,"younger","1","1"
"565",74,"74",6,"Antisocial","travelticket",3,5,4,2,3,-1,1,-2,6,2,"younger","1","0"
"566",74,"74",7,"Prosocial","organicVegetables",9,7,7,4,3,0,-1,2,6,2,"younger","1","1"
"567",74,"74",8,"Antisocial","parking",1,3,1,2,1,-2,-1,-2,6,2,"younger","1","0"
"568",74,"74",11,"Antisocial","late",3,5,4,5,3,-1,-2,-2,6,2,"younger","1","0"
"569",74,"74",12,"Antisocial","gathering",5,7,10,7,7,3,0,-2,6,2,"younger","1","0"
"570",75,"75",2,"Antisocial","gathering",3,5,2,2,1,-3,-1,-2,3,2,"younger","1","0"
"571",75,"75",4,"Prosocial","lendMoney",6,4,7,4,5,3,1,2,3,2,"younger","1","1"
"572",75,"75",6,"Prosocial","speed",5,3,6,6,3,3,-3,2,3,2,"younger","1","1"
"573",75,"75",8,"Antisocial","meat",6,8,8,6,5,0,-1,-2,3,2,"younger","1","0"
"574",75,"75",9,"Antisocial","chargers",6,8,7,6,3,-1,-3,-2,3,2,"younger","1","0"
"575",75,"75",10,"Prosocial","homeless",10,8,9,6,6,1,0,2,3,2,"younger","1","1"
"576",75,"75",11,"Prosocial","bike",8,6,8,2,5,2,3,2,3,2,"younger","1","1"
"577",75,"75",12,"Antisocial","shower",5,7,7,4,4,0,0,-2,3,2,"younger","1","0"
"578",76,"76",2,"Prosocial","queue",6,4,6,1,3,2,2,2,3,1,"younger","1","1"
"579",76,"76",4,"Prosocial","screentime",8,6,7,1,6,1,5,2,3,1,"younger","1","1"
"580",76,"76",5,"Antisocial","gathering",4,6,6,5,6,0,1,-2,3,1,"younger","1","0"
"581",76,"76",6,"Antisocial","chargers",4,6,6,7,7,0,0,-2,3,1,"younger","1","0"
"582",76,"76",10,"Antisocial","distance",4,6,5,6,7,-1,1,-2,3,1,"younger","1","0"
"583",76,"76",11,"Antisocial","meat",8,10,9,7,7,-1,0,-2,3,1,"younger","1","0"
"584",76,"76",12,"Prosocial","speed",11,9,10,3,7,1,4,2,3,1,"younger","1","1"
"585",77,"77",1,"Antisocial","chargers",4,6,3,3,6,-3,3,-2,5,2,"younger","1","0"
"586",77,"77",2,"Antisocial","shower",4,6,9,4,5,3,1,-2,5,2,"younger","1","0"
"587",77,"77",5,"Prosocial","vegetarian",8,6,6,1,2,0,1,2,5,2,"younger","1","1"
"588",77,"77",7,"Prosocial","speed",8,6,8,4,5,2,1,2,5,2,"younger","1","1"
"589",77,"77",8,"Prosocial","ownbag",8,6,9,1,1,3,0,2,5,2,"younger","1","1"
"590",77,"77",9,"Antisocial","meat",8,10,11,7,7,1,0,-2,5,2,"younger","1","0"
"591",77,"77",11,"Prosocial","sustainable",8,6,9,1,2,3,1,2,5,2,"younger","1","1"
"592",78,"78",1,"Antisocial","coughelbow",6,8,8,5,5,0,0,-2,5,2,"younger","1","0"
"593",78,"78",2,"Antisocial","shower",4,6,5,4,3,-1,-1,-2,5,2,"younger","1","0"
"594",78,"78",5,"Prosocial","vegetarian",9,7,6,4,3,-1,-1,2,5,2,"younger","1","1"
"595",78,"78",6,"Antisocial","chargers",1,3,3,4,4,0,0,-2,5,2,"younger","1","0"
"596",78,"78",7,"Prosocial","sustainable",8,6,9,4,6,3,2,2,5,2,"younger","1","1"
"597",78,"78",10,"Prosocial","bike",10,8,8,2,5,0,3,2,5,2,"younger","1","1"
"598",78,"78",12,"Antisocial","distance",8,10,7,3,4,-3,1,-2,5,2,"younger","1","0"
"599",79,"79",2,"Antisocial","chargers",3,5,4,7,7,-1,0,-2,5,2,"younger","1","0"
"600",79,"79",3,"Antisocial","distance",4,6,5,6,2,-1,-4,-2,5,2,"younger","1","0"
"601",79,"79",4,"Antisocial","heating",4,6,5,3,1,-1,-2,-2,5,2,"younger","1","0"
"602",79,"79",6,"Prosocial","queue",9,7,9,3,5,2,2,2,5,2,"younger","1","1"
"603",79,"79",7,"Antisocial","travelticket",4,6,11,7,7,5,0,-2,5,2,"younger","1","0"
"604",79,"79",8,"Prosocial","lendMoney",8,6,9,6,6,3,0,2,5,2,"younger","1","1"
"605",80,"80",3,"Prosocial","lendMoney",8,6,9,1,2,3,1,2,2,2,"younger","1","1"
"606",80,"80",5,"Prosocial","crossroad",10,8,6,4,2,-2,-2,2,2,2,"younger","1","1"
"607",80,"80",7,"Antisocial","chargers",4,6,8,5,6,2,1,-2,2,2,"younger","1","0"
"608",80,"80",8,"Prosocial","bike",10,8,8,6,3,0,-3,2,2,2,"younger","1","1"
"609",80,"80",9,"Antisocial","shower",4,6,7,4,6,1,2,-2,2,2,"younger","1","0"
"610",80,"80",10,"Prosocial","charity",10,8,7,5,6,-1,1,2,2,2,"younger","1","1"
"611",80,"80",11,"Antisocial","parking",4,6,7,5,5,1,0,-2,2,2,"younger","1","0"
"612",80,"80",12,"Antisocial","distance",9,11,7,5,1,-4,-4,-2,2,2,"younger","1","0"
"613",81,"81",1,"Antisocial","noisedisturbance",2,4,3,4,3,-1,-1,-2,2,2,"younger","1","0"
"614",81,"81",2,"Prosocial","vegetarian",8,6,6,5,3,0,-2,2,2,2,"younger","1","1"
"615",81,"81",5,"Antisocial","gathering",4,6,7,5,5,1,0,-2,2,2,"younger","1","0"
"616",81,"81",8,"Antisocial","distance",4,6,2,6,2,-4,-4,-2,2,2,"younger","1","0"
"617",81,"81",9,"Prosocial","homeless",10,8,6,3,4,-2,1,2,2,2,"younger","1","1"
"618",81,"81",10,"Prosocial","bike",10,8,11,5,5,3,0,2,2,2,"younger","1","1"
"619",81,"81",11,"Prosocial","speed",8,6,8,3,4,2,1,2,2,2,"younger","1","1"
"620",81,"81",12,"Antisocial","heating",5,7,2,3,2,-5,-1,-2,2,2,"younger","1","0"
"621",82,"82",1,"Antisocial","distance",8,10,10,6,7,0,1,-2,3,1,"younger","1","0"
"622",82,"82",2,"Prosocial","queue",9,7,10,5,6,3,1,2,3,1,"younger","1","1"
"623",82,"82",3,"Antisocial","noisedisturbance",1,3,10,6,1,7,-5,-2,3,1,"younger","1","0"
"624",82,"82",7,"Antisocial","coughelbow",3,5,10,7,2,5,-5,-2,3,1,"younger","1","0"
"625",82,"82",9,"Antisocial","shower",4,6,6,6,5,0,-1,-2,3,1,"younger","1","0"
"626",82,"82",10,"Prosocial","crossroad",11,9,11,4,4,2,0,2,3,1,"younger","1","1"
"627",82,"82",11,"Prosocial","sustainable",11,9,11,3,5,2,2,2,3,1,"younger","1","1"
"628",82,"82",12,"Prosocial","volunteer",11,9,11,4,4,2,0,2,3,1,"younger","1","1"
"629",83,"83",1,"Antisocial","gathering",1,3,1,2,3,-2,1,-2,4,1,"younger","1","0"
"630",83,"83",2,"Prosocial","homeless",9,7,9,2,7,2,5,2,4,1,"younger","1","1"
"631",83,"83",4,"Prosocial","lendMoney",8,6,7,2,5,1,3,2,4,1,"younger","1","1"
"632",83,"83",5,"Antisocial","distance",9,11,10,3,6,-1,3,-2,4,1,"younger","1","0"
"633",83,"83",6,"Antisocial","download",4,6,5,4,5,-1,1,-2,4,1,"younger","1","0"
"634",83,"83",7,"Prosocial","screentime",7,5,7,5,5,2,0,2,4,1,"younger","1","1"
"635",83,"83",10,"Antisocial","chargers",4,6,6,7,7,0,0,-2,4,1,"younger","1","0"
"636",83,"83",11,"Prosocial","charity",11,9,11,4,7,2,3,2,4,1,"younger","1","1"
"637",84,"84",1,"Prosocial","washands",11,9,8,5,5,-1,0,2,2,1,"younger","1","1"
"638",84,"84",2,"Antisocial","taxes",1,3,4,2,2,1,0,-2,2,1,"younger","1","0"
"639",84,"84",6,"Antisocial","coughelbow",2,4,3,2,2,-1,0,-2,2,1,"younger","1","0"
"640",84,"84",7,"Prosocial","volunteer",11,9,8,5,6,-1,1,2,2,1,"younger","1","1"
"641",84,"84",8,"Antisocial","lights",3,5,3,3,3,-2,0,-2,2,1,"younger","1","0"
"642",84,"84",10,"Antisocial","distance",3,5,4,4,2,-1,-2,-2,2,1,"younger","1","0"
"643",84,"84",11,"Prosocial","crossroad",10,8,8,6,6,0,0,2,2,1,"younger","1","1"
"644",84,"84",12,"Prosocial","queue",10,8,8,6,5,0,-1,2,2,1,"younger","1","1"
"645",85,"85",1,"Antisocial","distance",2,4,4,5,3,0,-2,-2,4,2,"younger","1","0"
"646",85,"85",2,"Antisocial","coughelbow",1,3,1,2,2,-2,0,-2,4,2,"younger","1","0"
"647",85,"85",3,"Prosocial","homeless",9,7,7,1,3,0,2,2,4,2,"younger","1","1"
"648",85,"85",4,"Prosocial","volunteer",9,7,8,1,1,1,0,2,4,2,"younger","1","1"
"649",85,"85",5,"Antisocial","shower",8,10,10,7,7,0,0,-2,4,2,"younger","1","0"
"650",85,"85",9,"Prosocial","sustainable",8,6,7,3,4,1,1,2,4,2,"younger","1","1"
"651",85,"85",11,"Antisocial","heating",6,8,4,2,2,-4,0,-2,4,2,"younger","1","0"
"652",85,"85",12,"Prosocial","lendMoney",9,7,6,5,3,-1,-2,2,4,2,"younger","1","1"
"653",86,"86",2,"Prosocial","volunteer",11,10,11,3,6,1,3,1,2,2,"younger","1","1"
"654",86,"86",3,"Antisocial","distance",1,3,1,3,1,-2,-2,-2,2,2,"younger","1","0"
"655",86,"86",5,"Antisocial","lights",4,6,5,3,3,-1,0,-2,2,2,"younger","1","0"
"656",86,"86",6,"Antisocial","shower",4,6,4,5,2,-2,-3,-2,2,2,"younger","1","0"
"657",86,"86",7,"Antisocial","late",4,6,4,4,3,-2,-1,-2,2,2,"younger","1","0"
"658",86,"86",9,"Prosocial","screentime",8,6,6,1,4,0,3,2,2,2,"younger","1","1"
"659",87,"87",1,"Antisocial","distance",9,11,11,5,7,0,2,-2,7,2,"younger","1","0"
"660",87,"87",6,"Prosocial","bike",11,10,8,1,2,-2,1,1,7,2,"younger","1","1"
"661",87,"87",8,"Prosocial","queue",5,1,6,4,1,5,-3,4,7,2,"younger","1","1"
"662",87,"87",10,"Prosocial","homeless",9,7,9,1,3,2,2,2,7,2,"younger","1","1"
"663",87,"87",11,"Prosocial","lendMoney",9,7,5,1,2,-2,1,2,7,2,"younger","1","1"
"664",88,"88",1,"Prosocial","bike",11,9,11,1,7,2,6,2,5,2,"younger","1","1"
"665",88,"88",2,"Prosocial","vegetarian",8,6,6,1,3,0,2,2,5,2,"younger","1","1"
"666",88,"88",4,"Antisocial","distance",3,5,4,7,5,-1,-2,-2,5,2,"younger","1","0"
"667",88,"88",5,"Prosocial","homeless",10,8,6,3,3,-2,0,2,5,2,"younger","1","1"
"668",88,"88",7,"Prosocial","screentime",8,6,10,4,6,4,2,2,5,2,"younger","1","1"
"669",88,"88",8,"Antisocial","chargers",4,6,6,6,6,0,0,-2,5,2,"younger","1","0"
"670",88,"88",9,"Antisocial","lights",2,4,4,2,3,0,1,-2,5,2,"younger","1","0"
"671",88,"88",11,"Antisocial","gathering",3,5,2,2,2,-3,0,-2,5,2,"younger","1","0"
"672",89,"89",1,"Antisocial","distance",6,9,2,7,3,-7,-4,-3,2,2,"younger","1","0"
"673",89,"89",2,"Prosocial","homeless",10,8,3,1,1,-5,0,2,2,2,"younger","1","1"
"674",89,"89",3,"Prosocial","queue",6,4,3,2,1,-1,-1,2,2,2,"younger","1","1"
"675",89,"89",4,"Antisocial","chargers",7,9,6,7,7,-3,0,-2,2,2,"younger","1","0"
"676",89,"89",6,"Antisocial","meat",9,11,11,7,7,0,0,-2,2,2,"younger","1","0"
"677",89,"89",7,"Prosocial","crossroad",11,9,8,2,2,-1,0,2,2,2,"younger","1","1"
"678",89,"89",10,"Antisocial","shower",7,9,8,7,7,-1,0,-2,2,2,"younger","1","0"
"679",89,"89",12,"Prosocial","volunteer",11,9,10,1,5,1,4,2,2,2,"younger","1","1"
"680",90,"90",1,"Antisocial","lights",4,6,6,5,5,0,0,-2,2,1,"younger","1","0"
"681",90,"90",3,"Antisocial","shower",6,8,7,6,7,-1,1,-2,2,1,"younger","1","0"
"682",90,"90",4,"Prosocial","sustainable",10,8,8,6,5,0,-1,2,2,1,"younger","1","1"
"683",90,"90",5,"Prosocial","crossroad",10,8,9,4,6,1,2,2,2,1,"younger","1","1"
"684",90,"90",7,"Antisocial","meat",6,8,8,7,7,0,0,-2,2,1,"younger","1","0"
"685",90,"90",8,"Prosocial","vegetarian",8,6,6,1,2,0,1,2,2,1,"younger","1","1"
"686",90,"90",9,"Prosocial","charity",11,9,8,5,5,-1,0,2,2,1,"younger","1","1"
"687",90,"90",12,"Antisocial","download",4,6,5,5,5,-1,0,-2,2,1,"younger","1","0"
"688",91,"91",2,"Prosocial","queue",11,9,11,3,6,2,3,2,6,1,"younger","1","1"
"689",91,"91",3,"Prosocial","screentime",9,7,10,2,6,3,4,2,6,1,"younger","1","1"
"690",91,"91",4,"Prosocial","speed",11,9,10,6,6,1,0,2,6,1,"younger","1","1"
"691",91,"91",7,"Antisocial","lights",1,3,3,3,2,0,-1,-2,6,1,"younger","1","0"
"692",91,"91",8,"Prosocial","bike",11,9,11,1,1,2,0,2,6,1,"younger","1","1"
"693",91,"91",9,"Antisocial","chargers",3,5,1,5,3,-4,-2,-2,6,1,"younger","1","0"
"694",91,"91",10,"Antisocial","shower",4,6,2,5,4,-4,-1,-2,6,1,"younger","1","0"
"695",91,"91",12,"Antisocial","late",4,6,2,5,3,-4,-2,-2,6,1,"younger","1","0"
"696",92,"92",1,"Antisocial","distance",1,3,3,6,5,0,-1,-2,5,1,"younger","1","0"
"697",92,"92",3,"Prosocial","homeless",9,7,10,3,6,3,3,2,5,1,"younger","1","1"
"698",92,"92",4,"Antisocial","shower",3,5,2,2,1,-3,-1,-2,5,1,"younger","1","0"
"699",92,"92",6,"Antisocial","gathering",2,4,2,2,2,-2,0,-2,5,1,"younger","1","0"
"700",92,"92",8,"Prosocial","seatBus",10,8,10,3,3,2,0,2,5,1,"younger","1","1"
"701",92,"92",10,"Antisocial","redlights",2,4,4,3,3,0,0,-2,5,1,"younger","1","0"
"702",92,"92",11,"Prosocial","washands",9,7,11,6,7,4,1,2,5,1,"younger","1","1"
"703",92,"92",12,"Prosocial","queue",11,9,10,4,5,1,1,2,5,1,"younger","1","1"
"704",93,"93",4,"Prosocial","sustainable",10,8,10,5,5,2,0,2,3,1,"younger","1","1"
"705",93,"93",5,"Prosocial","vegetarian",9,7,10,5,3,3,-2,2,3,1,"younger","1","1"
"706",93,"93",6,"Antisocial","travelticket",1,3,1,2,1,-2,-1,-2,3,1,"younger","1","0"
"707",93,"93",7,"Antisocial","meat",5,7,7,7,7,0,0,-2,3,1,"younger","1","0"
"708",93,"93",8,"Antisocial","late",1,3,1,2,1,-2,-1,-2,3,1,"younger","1","0"
"709",93,"93",9,"Antisocial","heating",3,5,4,2,1,-1,-1,-2,3,1,"younger","1","0"
"710",93,"93",10,"Prosocial","screentime",7,5,5,3,2,0,-1,2,3,1,"younger","1","1"
"711",93,"93",12,"Prosocial","crossroad",11,9,8,4,3,-1,-1,2,3,1,"younger","1","1"
"712",94,"94",2,"Antisocial","shower",4,6,5,5,6,-1,1,-2,3,2,"younger","1","0"
"713",94,"94",5,"Prosocial","queue",8,6,8,5,7,2,2,2,3,2,"younger","1","1"
"714",94,"94",6,"Antisocial","chargers",4,6,3,7,6,-3,-1,-2,3,2,"younger","1","0"
"715",94,"94",7,"Prosocial","charity",11,9,11,5,7,2,2,2,3,2,"younger","1","1"
"716",94,"94",8,"Prosocial","bike",10,8,7,1,2,-1,1,2,3,2,"younger","1","1"
"717",94,"94",10,"Antisocial","gathering",6,8,4,4,3,-4,-1,-2,3,2,"younger","1","0"
"718",94,"94",11,"Prosocial","screentime",8,6,8,3,5,2,2,2,3,2,"younger","1","1"
"719",94,"94",12,"Antisocial","distance",9,11,9,7,3,-2,-4,-2,3,2,"younger","1","0"
"720",95,"95",1,"Prosocial","speed",11,9,9,6,5,0,-1,2,7,1,"younger","1","1"
"721",95,"95",2,"Prosocial","volunteer",11,9,11,4,5,2,1,2,7,1,"younger","1","1"
"722",95,"95",5,"Antisocial","noisedisturbance",2,4,1,2,1,-3,-1,-2,7,1,"younger","1","0"
"723",95,"95",7,"Prosocial","queue",7,5,8,4,4,3,0,2,7,1,"younger","1","1"
"724",95,"95",8,"Antisocial","travelticket",6,8,7,5,5,-1,0,-2,7,1,"younger","1","0"
"725",95,"95",9,"Prosocial","sustainable",11,9,11,5,5,2,0,2,7,1,"younger","1","1"
"726",95,"95",10,"Antisocial","meat",5,7,6,7,6,-1,-1,-2,7,1,"younger","1","0"
"727",95,"95",11,"Antisocial","distance",1,3,1,2,1,-2,-1,-2,7,1,"younger","1","0"
"728",96,"96",1,"Prosocial","sustainable",9,7,9,5,7,2,2,2,5,1,"younger","1","1"
"729",96,"96",3,"Prosocial","speed",9,7,5,6,3,-2,-3,2,5,1,"younger","1","1"
"730",96,"96",4,"Antisocial","late",6,8,6,5,5,-2,0,-2,5,1,"younger","1","0"
"731",96,"96",5,"Antisocial","meat",9,11,9,7,6,-2,-1,-2,5,1,"younger","1","0"
"732",96,"96",6,"Prosocial","volunteer",10,8,11,6,7,3,1,2,5,1,"younger","1","1"
"733",96,"96",7,"Antisocial","travelticket",8,10,10,7,6,0,-1,-2,5,1,"younger","1","0"
"734",96,"96",8,"Prosocial","bike",7,5,4,2,3,-1,1,2,5,1,"younger","1","1"
"735",96,"96",10,"Antisocial","distance",9,11,11,7,7,0,0,-2,5,1,"younger","1","0"
"736",97,"97",3,"Prosocial","ownbag",11,9,10,5,6,1,1,2,5,1,"younger","1","1"
"737",97,"97",4,"Prosocial","seatBus",10,8,8,6,5,0,-1,2,5,1,"younger","1","1"
"738",97,"97",6,"Antisocial","travelticket",6,8,9,5,5,1,0,-2,5,1,"younger","1","0"
"739",97,"97",7,"Prosocial","queue",10,8,9,6,6,1,0,2,5,1,"younger","1","1"
"740",97,"97",8,"Antisocial","meat",5,7,7,6,5,0,-1,-2,5,1,"younger","1","0"
"741",97,"97",10,"Antisocial","chargers",5,7,7,7,4,0,-3,-2,5,1,"younger","1","0"
"742",97,"97",11,"Antisocial","gathering",5,7,7,5,5,0,0,-2,5,1,"younger","1","0"
"743",97,"97",12,"Prosocial","facemask",11,9,8,6,6,-1,0,2,5,1,"younger","1","1"
"744",98,"98",3,"Prosocial","homeless",10,8,11,2,3,3,1,2,1,2,"younger","1","1"
"745",98,"98",4,"Antisocial","chargers",4,6,5,7,7,-1,0,-2,1,2,"younger","1","0"
"746",98,"98",5,"Antisocial","heating",3,5,4,3,3,-1,0,-2,1,2,"younger","1","0"
"747",98,"98",6,"Prosocial","lendMoney",9,7,9,4,6,2,2,2,1,2,"younger","1","1"
"748",98,"98",7,"Prosocial","bike",10,8,11,1,1,3,0,2,1,2,"younger","1","1"
"749",98,"98",8,"Antisocial","late",1,3,2,2,2,-1,0,-2,1,2,"younger","1","0"
"750",98,"98",10,"Antisocial","meat",5,7,8,7,7,1,0,-2,1,2,"younger","1","0"
"751",98,"98",12,"Prosocial","speed",9,7,7,5,4,0,-1,2,1,2,"younger","1","1"
"752",99,"99",1,"Antisocial","chargers",4,6,5,5,5,-1,0,-2,3,2,"younger","1","0"
"753",99,"99",2,"Prosocial","homeless",8,6,7,1,1,1,0,2,3,2,"younger","1","1"
"754",99,"99",5,"Prosocial","crossroad",9,7,9,1,3,2,2,2,3,2,"younger","1","1"
"755",99,"99",6,"Antisocial","late",3,5,4,2,2,-1,0,-2,3,2,"younger","1","0"
"756",99,"99",7,"Antisocial","shower",4,6,3,2,2,-3,0,-2,3,2,"younger","1","0"
"757",99,"99",8,"Antisocial","distance",3,5,3,6,3,-2,-3,-2,3,2,"younger","1","0"
"758",99,"99",9,"Prosocial","queue",9,7,8,4,5,1,1,2,3,2,"younger","1","1"
"759",99,"99",11,"Prosocial","lendMoney",8,6,6,1,3,0,2,2,3,2,"younger","1","1"
"760",100,"100",1,"Prosocial","charity",11,9,11,5,6,2,1,2,4,1,"younger","1","1"
"761",100,"100",2,"Prosocial","screentime",10,8,10,6,6,2,0,2,4,1,"younger","1","1"
"762",100,"100",3,"Antisocial","lights",1,3,1,3,1,-2,-2,-2,4,1,"younger","1","0"
"763",100,"100",5,"Antisocial","shower",1,4,3,6,5,-1,-1,-3,4,1,"younger","1","0"
"764",100,"100",7,"Prosocial","vegetarian",7,5,7,3,5,2,2,2,4,1,"younger","1","1"
"765",100,"100",8,"Antisocial","chargers",3,5,4,5,5,-1,0,-2,4,1,"younger","1","0"
"766",100,"100",9,"Antisocial","meat",7,9,8,7,7,-1,0,-2,4,1,"younger","1","0"
"767",100,"100",11,"Prosocial","bike",11,9,7,1,1,-2,0,2,4,1,"younger","1","1"
"768",101,"101",2,"Antisocial","redlights",1,3,1,2,1,-2,-1,-2,3,1,"younger","1","0"
"769",101,"101",4,"Prosocial","lendMoney",11,9,10,5,5,1,0,2,3,1,"younger","1","1"
"770",101,"101",5,"Antisocial","chargers",7,9,6,7,6,-3,-1,-2,3,1,"younger","1","0"
"771",101,"101",7,"Prosocial","screentime",11,9,11,5,7,2,2,2,3,1,"younger","1","1"
"772",101,"101",8,"Antisocial","late",3,5,4,3,1,-1,-2,-2,3,1,"younger","1","0"
"773",101,"101",9,"Antisocial","gathering",5,7,4,5,2,-3,-3,-2,3,1,"younger","1","0"
"774",101,"101",12,"Prosocial","speed",11,9,11,5,7,2,2,2,3,1,"younger","1","1"
"775",102,"102",1,"Prosocial","washands",11,9,11,5,6,2,1,2,4,1,"younger","1","1"
"776",102,"102",2,"Antisocial","meat",9,11,11,7,7,0,0,-2,4,1,"younger","1","0"
"777",102,"102",3,"Antisocial","shower",6,8,7,7,4,-1,-3,-2,4,1,"younger","1","0"
"778",102,"102",4,"Prosocial","speed",7,5,5,1,2,0,1,2,4,1,"younger","1","1"
"779",102,"102",7,"Prosocial","bike",9,7,11,1,6,4,5,2,4,1,"younger","1","1"
"780",102,"102",8,"Antisocial","distance",5,7,9,6,6,2,0,-2,4,1,"younger","1","0"
"781",102,"102",11,"Antisocial","lights",4,6,6,6,5,0,-1,-2,4,1,"younger","1","0"
"782",102,"102",12,"Prosocial","sustainable",6,4,2,2,1,-2,-1,2,4,1,"younger","1","1"
"783",103,"103",2,"Prosocial","queue",11,9,10,6,6,1,0,2,4,2,"younger","1","1"
"784",103,"103",3,"Antisocial","noisedisturbance",2,4,3,2,2,-1,0,-2,4,2,"younger","1","0"
"785",103,"103",4,"Prosocial","sustainable",10,8,11,5,6,3,1,2,4,2,"younger","1","1"
"786",103,"103",6,"Antisocial","taxes",1,4,1,1,1,-3,0,-3,4,2,"younger","1","0"
"787",103,"103",7,"Antisocial","distance",3,5,4,5,2,-1,-3,-2,4,2,"younger","1","0"
"788",103,"103",8,"Antisocial","late",1,3,2,2,1,-1,-1,-2,4,2,"younger","1","0"
"789",103,"103",9,"Prosocial","screentime",8,6,6,1,4,0,3,2,4,2,"younger","1","1"
"790",103,"103",11,"Prosocial","homeless",10,8,9,4,4,1,0,2,4,2,"younger","1","1"
"791",104,"104",1,"Antisocial","chargers",4,6,5,7,7,-1,0,-2,2,1,"younger","1","0"
"792",104,"104",2,"Antisocial","meat",5,7,6,7,7,-1,0,-2,2,1,"younger","1","0"
"793",104,"104",3,"Prosocial","charity",11,9,11,2,2,2,0,2,2,1,"younger","1","1"
"794",104,"104",4,"Prosocial","lendMoney",6,4,6,2,5,2,3,2,2,1,"younger","1","1"
"795",104,"104",5,"Prosocial","screentime",10,8,8,1,3,0,2,2,2,1,"younger","1","1"
"796",104,"104",7,"Antisocial","lights",4,6,6,7,7,0,0,-2,2,1,"younger","1","0"
"797",104,"104",8,"Prosocial","homeless",6,1,5,1,2,4,1,5,2,1,"younger","1","1"
"798",104,"104",9,"Antisocial","distance",9,11,10,5,7,-1,2,-2,2,1,"younger","1","0"
"799",105,"105",1,"Prosocial","volunteer",11,9,11,1,4,2,3,2,4,1,"younger","1","1"
"800",105,"105",4,"Antisocial","distance",6,9,2,4,7,-7,3,-3,4,1,"younger","1","0"
"801",105,"105",6,"Antisocial","gathering",1,3,2,2,1,-1,-1,-2,4,1,"younger","1","0"
"802",105,"105",7,"Prosocial","screentime",8,6,6,1,2,0,1,2,4,1,"younger","1","1"
"803",105,"105",8,"Antisocial","meat",9,11,11,7,7,0,0,-2,4,1,"younger","1","0"
"804",105,"105",9,"Antisocial","shower",4,6,3,2,1,-3,-1,-2,4,1,"younger","1","0"
"805",105,"105",10,"Prosocial","crossroad",11,9,11,1,7,2,6,2,4,1,"younger","1","1"
"806",105,"105",11,"Prosocial","sustainable",9,7,6,1,1,-1,0,2,4,1,"younger","1","1"
"807",106,"106",2,"Prosocial","vegetarian",8,6,8,2,5,2,3,2,5,2,"younger","1","1"
"808",106,"106",3,"Antisocial","gathering",2,4,2,6,2,-2,-4,-2,5,2,"younger","1","0"
"809",106,"106",5,"Prosocial","seatBus",10,8,10,5,5,2,0,2,5,2,"younger","1","1"
"810",106,"106",6,"Prosocial","crossroad",10,8,9,1,3,1,2,2,5,2,"younger","1","1"
"811",106,"106",8,"Antisocial","distance",2,4,2,5,6,-2,1,-2,5,2,"younger","1","0"
"812",106,"106",9,"Prosocial","ownbag",11,9,10,6,6,1,0,2,5,2,"younger","1","1"
"813",106,"106",11,"Antisocial","shower",7,9,3,2,5,-6,3,-2,5,2,"younger","1","0"
"814",107,"107",2,"Antisocial","shower",3,5,6,7,4,1,-3,-2,4,2,"younger","1","0"
"815",107,"107",4,"Prosocial","crossroad",11,9,9,5,6,0,1,2,4,2,"younger","1","1"
"816",107,"107",5,"Antisocial","download",1,3,6,3,4,3,1,-2,4,2,"younger","1","0"
"817",107,"107",6,"Prosocial","screentime",9,7,6,1,3,-1,2,2,4,2,"younger","1","1"
"818",107,"107",7,"Prosocial","bike",9,7,8,1,2,1,1,2,4,2,"younger","1","1"
"819",107,"107",9,"Antisocial","lights",2,4,2,3,1,-2,-2,-2,4,2,"younger","1","0"
"820",107,"107",11,"Prosocial","vegetarian",10,8,7,3,2,-1,-1,2,4,2,"younger","1","1"
"821",107,"107",12,"Antisocial","chargers",4,6,4,7,4,-2,-3,-2,4,2,"younger","1","0"
"822",108,"108",1,"Prosocial","bike",9,7,9,1,1,2,0,2,5,1,"younger","1","1"
"823",108,"108",2,"Antisocial","redlights",2,4,3,3,2,-1,-1,-2,5,1,"younger","1","0"
"824",108,"108",3,"Prosocial","washands",9,7,10,3,5,3,2,2,5,1,"younger","1","1"
"825",108,"108",5,"Antisocial","chargers",4,6,7,2,2,1,0,-2,5,1,"younger","1","0"
"826",108,"108",6,"Antisocial","parking",2,4,1,2,2,-3,0,-2,5,1,"younger","1","0"
"827",108,"108",9,"Prosocial","screentime",8,6,10,1,1,4,0,2,5,1,"younger","1","1"
"828",108,"108",11,"Antisocial","download",6,8,9,2,6,1,4,-2,5,1,"younger","1","0"
"829",108,"108",12,"Prosocial","queue",8,6,8,2,4,2,2,2,5,1,"younger","1","1"
"830",109,"109",1,"Antisocial","shower",4,6,4,3,2,-2,-1,-2,3,1,"younger","1","0"
"831",109,"109",3,"Prosocial","screentime",8,6,9,5,7,3,2,2,3,1,"younger","1","1"
"832",109,"109",4,"Antisocial","chargers",4,6,4,5,3,-2,-2,-2,3,1,"younger","1","0"
"833",109,"109",6,"Antisocial","meat",7,9,9,3,6,0,3,-2,3,1,"younger","1","0"
"834",109,"109",7,"Antisocial","travelticket",3,5,4,2,2,-1,0,-2,3,1,"younger","1","0"
"835",109,"109",8,"Prosocial","charity",8,6,9,4,6,3,2,2,3,1,"younger","1","1"
"836",109,"109",11,"Prosocial","bike",8,6,8,1,3,2,2,2,3,1,"younger","1","1"
"837",109,"109",12,"Prosocial","homeless",10,8,10,4,5,2,1,2,3,1,"younger","1","1"
"838",110,"110",1,"Prosocial","bike",8,6,6,1,4,0,3,2,2,2,"younger","1","1"
"839",110,"110",4,"Prosocial","queue",10,8,6,1,2,-2,1,2,2,2,"younger","1","1"
"840",110,"110",6,"Antisocial","distance",9,11,1,7,7,-10,0,-2,2,2,"younger","1","0"
"841",110,"110",8,"Antisocial","chargers",5,7,6,7,7,-1,0,-2,2,2,"younger","1","0"
"842",110,"110",10,"Prosocial","screentime",8,6,6,5,7,0,2,2,2,2,"younger","1","1"
"843",110,"110",12,"Prosocial","lendMoney",8,6,6,1,1,0,0,2,2,2,"younger","1","1"
"844",111,"111",1,"Antisocial","distance",4,6,11,7,4,5,-3,-2,1,1,"younger","1","0"
"845",111,"111",2,"Prosocial","sustainable",8,6,6,1,4,0,3,2,1,1,"younger","1","1"
"846",111,"111",3,"Prosocial","bike",8,6,8,2,4,2,2,2,1,1,"younger","1","1"
"847",111,"111",4,"Antisocial","lights",4,6,7,7,6,1,-1,-2,1,1,"younger","1","0"
"848",111,"111",6,"Antisocial","shower",4,6,5,4,2,-1,-2,-2,1,1,"younger","1","0"
"849",111,"111",9,"Prosocial","queue",8,6,6,4,3,0,-1,2,1,1,"younger","1","1"
"850",111,"111",11,"Antisocial","chargers",4,6,6,7,7,0,0,-2,1,1,"younger","1","0"
"851",111,"111",12,"Prosocial","volunteer",8,6,10,1,1,4,0,2,1,1,"younger","1","1"
"852",112,"112",1,"Prosocial","screentime",10,8,10,2,2,2,0,2,3,1,"younger","1","1"
"853",112,"112",2,"Antisocial","gathering",3,5,8,7,5,3,-2,-2,3,1,"younger","1","0"
"854",112,"112",4,"Antisocial","chargers",7,9,9,7,7,0,0,-2,3,1,"younger","1","0"
"855",112,"112",5,"Prosocial","sustainable",9,7,10,4,7,3,3,2,3,1,"younger","1","1"
"856",112,"112",7,"Prosocial","queue",9,7,10,5,7,3,2,2,3,1,"younger","1","1"
"857",112,"112",10,"Antisocial","distance",9,11,11,7,4,0,-3,-2,3,1,"younger","1","0"
"858",112,"112",11,"Antisocial","shower",9,11,10,5,7,-1,2,-2,3,1,"younger","1","0"
"859",113,"113",2,"Antisocial","shower",4,6,5,5,4,-1,-1,-2,3,2,"younger","1","0"
"860",113,"113",4,"Antisocial","late",3,5,3,2,2,-2,0,-2,3,2,"younger","1","0"
"861",113,"113",6,"Prosocial","charity",9,7,8,4,4,1,0,2,3,2,"younger","1","1"
"862",113,"113",7,"Prosocial","queue",8,6,6,4,4,0,0,2,3,2,"younger","1","1"
"863",113,"113",8,"Prosocial","crossroad",9,7,8,1,3,1,2,2,3,2,"younger","1","1"
"864",113,"113",9,"Prosocial","recycle",10,8,9,6,6,1,0,2,3,2,"younger","1","1"
"865",113,"113",10,"Antisocial","distance",3,5,2,3,2,-3,-1,-2,3,2,"younger","1","0"
"866",113,"113",12,"Antisocial","gathering",2,4,1,2,2,-3,0,-2,3,2,"younger","1","0"
"867",114,"114",1,"Prosocial","volunteer",9,7,8,1,5,1,4,2,2,1,"younger","1","1"
"868",114,"114",3,"Antisocial","chargers",4,6,5,7,7,-1,0,-2,2,1,"younger","1","0"
"869",114,"114",5,"Antisocial","shower",5,7,7,7,7,0,0,-2,2,1,"younger","1","0"
"870",114,"114",8,"Prosocial","charity",9,7,8,3,4,1,1,2,2,1,"younger","1","1"
"871",114,"114",9,"Antisocial","late",4,6,5,5,4,-1,-1,-2,2,1,"younger","1","0"
"872",114,"114",10,"Prosocial","bike",9,7,8,4,5,1,1,2,2,1,"younger","1","1"
"873",114,"114",11,"Antisocial","gathering",1,3,3,3,2,0,-1,-2,2,1,"younger","1","0"
"874",114,"114",12,"Prosocial","seatBus",9,7,8,5,5,1,0,2,2,1,"younger","1","1"
"875",115,"115",1,"Prosocial","homeless",10,8,8,4,2,0,-2,2,3,1,"younger","1","1"
"876",115,"115",4,"Antisocial","noisedisturbance",1,3,1,2,4,-2,2,-2,3,1,"younger","1","0"
"877",115,"115",5,"Prosocial","speed",9,7,8,5,6,1,1,2,3,1,"younger","1","1"
"878",115,"115",7,"Antisocial","heating",2,4,1,3,1,-3,-2,-2,3,1,"younger","1","0"
"879",115,"115",8,"Antisocial","late",2,4,2,2,3,-2,1,-2,3,1,"younger","1","0"
"880",115,"115",9,"Prosocial","lendMoney",7,5,6,3,2,1,-1,2,3,1,"younger","1","1"
"881",115,"115",11,"Prosocial","recycle",11,9,11,6,7,2,1,2,3,1,"younger","1","1"
"882",115,"115",12,"Antisocial","meat",5,7,7,7,6,0,-1,-2,3,1,"younger","1","0"
"883",116,"116",1,"Antisocial","download",4,6,7,4,3,1,-1,-2,4,1,"younger","1","0"
"884",116,"116",3,"Prosocial","screentime",8,6,8,1,4,2,3,2,4,1,"younger","1","1"
"885",116,"116",4,"Prosocial","lendMoney",11,9,6,4,5,-3,1,2,4,1,"younger","1","1"
"886",116,"116",5,"Antisocial","lights",4,6,4,2,2,-2,0,-2,4,1,"younger","1","0"
"887",116,"116",7,"Prosocial","charity",11,9,10,4,4,1,0,2,4,1,"younger","1","1"
"888",116,"116",9,"Antisocial","distance",9,11,11,7,7,0,0,-2,4,1,"younger","1","0"
"889",116,"116",11,"Antisocial","shower",4,6,5,7,6,-1,-1,-2,4,1,"younger","1","0"
"890",116,"116",12,"Prosocial","queue",11,9,10,6,6,1,0,2,4,1,"younger","1","1"
"891",117,"117",2,"Prosocial","queue",8,6,7,3,3,1,0,2,4,1,"younger","1","1"
"892",117,"117",3,"Prosocial","recycle",11,9,10,6,7,1,1,2,4,1,"younger","1","1"
"893",117,"117",4,"Antisocial","distance",5,7,6,6,5,-1,-1,-2,4,1,"younger","1","0"
"894",117,"117",5,"Antisocial","travelticket",4,6,5,2,1,-1,-1,-2,4,1,"younger","1","0"
"895",117,"117",7,"Antisocial","chargers",4,6,6,6,7,0,1,-2,4,1,"younger","1","0"
"896",117,"117",8,"Prosocial","ownbag",11,9,11,6,7,2,1,2,4,1,"younger","1","1"
"897",117,"117",9,"Antisocial","coughelbow",3,5,3,2,4,-2,2,-2,4,1,"younger","1","0"
"898",117,"117",12,"Prosocial","speed",6,4,4,2,1,0,-1,2,4,1,"younger","1","1"
"899",118,"118",1,"Prosocial","queue",10,8,8,5,5,0,0,2,5,2,"younger","1","1"
"900",118,"118",3,"Antisocial","gathering",3,5,2,6,4,-3,-2,-2,5,2,"younger","1","0"
"901",118,"118",6,"Prosocial","speed",11,9,11,6,7,2,1,2,5,2,"younger","1","1"
"902",118,"118",7,"Prosocial","vegetarian",10,8,10,2,5,2,3,2,5,2,"younger","1","1"
"903",118,"118",8,"Antisocial","heating",4,6,6,4,3,0,-1,-2,5,2,"younger","1","0"
"904",118,"118",9,"Antisocial","meat",8,10,10,7,6,0,-1,-2,5,2,"younger","1","0"
"905",118,"118",10,"Prosocial","bike",11,9,7,1,4,-2,3,2,5,2,"younger","1","1"
"906",118,"118",12,"Antisocial","chargers",4,6,2,4,4,-4,0,-2,5,2,"younger","1","0"
"907",119,"119",1,"Prosocial","sustainable",10,8,11,4,4,3,0,2,1,2,"younger","1","1"
"908",119,"119",2,"Prosocial","speed",8,6,6,1,5,0,4,2,1,2,"younger","1","1"
"909",119,"119",3,"Antisocial","travelticket",6,8,6,4,1,-2,-3,-2,1,2,"younger","1","0"
"910",119,"119",6,"Antisocial","gathering",2,4,2,5,2,-2,-3,-2,1,2,"younger","1","0"
"911",119,"119",7,"Antisocial","chargers",4,6,9,7,6,3,-1,-2,1,2,"younger","1","0"
"912",119,"119",8,"Prosocial","homeless",8,6,9,1,2,3,1,2,1,2,"younger","1","1"
"913",119,"119",10,"Prosocial","crossroad",8,6,6,1,3,0,2,2,1,2,"younger","1","1"
"914",119,"119",12,"Antisocial","shower",1,3,1,7,2,-2,-5,-2,1,2,"younger","1","0"
"915",120,"120",1,"Antisocial","chargers",4,6,6,4,4,0,0,-2,3,1,"younger","1","0"
"916",120,"120",2,"Antisocial","travelticket",6,9,9,4,5,0,1,-3,3,1,"younger","1","0"
"917",120,"120",3,"Antisocial","shower",5,7,6,6,4,-1,-2,-2,3,1,"younger","1","0"
"918",120,"120",9,"Antisocial","download",7,9,8,7,6,-1,-1,-2,3,1,"younger","1","0"
"919",120,"120",11,"Prosocial","lendMoney",11,9,7,5,6,-2,1,2,3,1,"younger","1","1"
"920",121,"121",1,"Antisocial","lights",4,6,4,6,5,-2,-1,-2,3,2,"younger","1","0"
"921",121,"121",2,"Prosocial","vegetarian",8,6,4,1,1,-2,0,2,3,2,"younger","1","1"
"922",121,"121",4,"Prosocial","crossroad",10,8,8,2,3,0,1,2,3,2,"younger","1","1"
"923",121,"121",6,"Antisocial","distance",8,10,10,7,6,0,-1,-2,3,2,"younger","1","0"
"924",121,"121",8,"Prosocial","homeless",9,7,6,2,2,-1,0,2,3,2,"younger","1","1"
"925",121,"121",9,"Antisocial","garbage",1,3,2,3,1,-1,-2,-2,3,2,"younger","1","0"
"926",121,"121",10,"Antisocial","meat",8,10,10,7,7,0,0,-2,3,2,"younger","1","0"
"927",121,"121",11,"Prosocial","queue",8,6,6,4,3,0,-1,2,3,2,"younger","1","1"
"928",122,"122",1,"Antisocial","chargers",5,7,11,7,7,4,0,-2,2,1,"younger","1","0"
"929",122,"122",4,"Prosocial","screentime",9,7,6,1,2,-1,1,2,2,1,"younger","1","1"
"930",122,"122",5,"Prosocial","homeless",10,8,1,1,1,-7,0,2,2,1,"younger","1","1"
"931",122,"122",6,"Prosocial","speed",6,3,1,5,1,-2,-4,3,2,1,"younger","1","1"
"932",122,"122",7,"Antisocial","shower",8,10,11,7,7,1,0,-2,2,1,"younger","1","0"
"933",122,"122",8,"Antisocial","distance",4,6,11,7,7,5,0,-2,2,1,"younger","1","0"
"934",122,"122",9,"Prosocial","lendMoney",7,5,6,3,1,1,-2,2,2,1,"younger","1","1"
"935",122,"122",11,"Antisocial","meat",9,11,11,7,7,0,0,-2,2,1,"younger","1","0"
"936",123,"123",1,"Antisocial","download",5,7,5,3,4,-2,1,-2,5,2,"younger","1","0"
"937",123,"123",2,"Prosocial","screentime",10,8,11,5,7,3,2,2,5,2,"younger","1","1"
"938",123,"123",6,"Antisocial","chargers",7,9,9,7,7,0,0,-2,5,2,"younger","1","0"
"939",123,"123",7,"Prosocial","speed",9,7,8,5,4,1,-1,2,5,2,"younger","1","1"
"940",123,"123",8,"Prosocial","charity",10,8,11,1,7,3,6,2,5,2,"younger","1","1"
"941",123,"123",9,"Prosocial","washands",11,9,11,5,6,2,1,2,5,2,"younger","1","1"
"942",123,"123",10,"Antisocial","meat",9,11,10,7,7,-1,0,-2,5,2,"younger","1","0"
"943",123,"123",11,"Antisocial","distance",4,6,3,5,3,-3,-2,-2,5,2,"younger","1","0"
"944",124,"124",1,"Antisocial","cyberbully",3,5,4,4,3,-1,-1,-2,2,2,"younger","1","0"
"945",124,"124",4,"Prosocial","speed",9,7,7,3,5,0,2,2,2,2,"younger","1","1"
"946",124,"124",5,"Prosocial","screentime",8,6,7,4,4,1,0,2,2,2,"younger","1","1"
"947",124,"124",6,"Antisocial","chargers",4,6,6,7,6,0,-1,-2,2,2,"younger","1","0"
"948",124,"124",7,"Antisocial","lights",3,5,4,2,2,-1,0,-2,2,2,"younger","1","0"
"949",124,"124",8,"Prosocial","vegetarian",10,8,8,1,5,0,4,2,2,2,"younger","1","1"
"950",124,"124",10,"Prosocial","sustainable",8,6,7,1,4,1,3,2,2,2,"younger","1","1"
"951",124,"124",12,"Antisocial","shower",3,5,6,2,4,1,2,-2,2,2,"younger","1","0"
"952",125,"125",2,"Prosocial","screentime",11,9,9,4,6,0,2,2,6,1,"younger","1","1"
"953",125,"125",3,"Antisocial","lights",1,3,6,3,2,3,-1,-2,6,1,"younger","1","0"
"954",125,"125",4,"Prosocial","vegetarian",11,9,11,6,7,2,1,2,6,1,"younger","1","1"
"955",125,"125",5,"Antisocial","coughelbow",4,6,2,6,2,-4,-4,-2,6,1,"younger","1","0"
"956",125,"125",8,"Prosocial","ownbag",10,8,10,6,7,2,1,2,6,1,"younger","1","1"
"957",125,"125",9,"Antisocial","late",1,3,1,3,1,-2,-2,-2,6,1,"younger","1","0"
"958",125,"125",10,"Antisocial","noisedisturbance",1,3,1,5,2,-2,-3,-2,6,1,"younger","1","0"
"959",125,"125",11,"Prosocial","bike",8,6,8,4,6,2,2,2,6,1,"younger","1","1"
"960",126,"126",2,"Prosocial","vegetarian",11,9,8,4,4,-1,0,2,4,2,"younger","1","1"
"961",126,"126",3,"Antisocial","shower",4,6,8,7,4,2,-3,-2,4,2,"younger","1","0"
"962",126,"126",5,"Prosocial","queue",11,9,11,6,6,2,0,2,4,2,"younger","1","1"
"963",126,"126",8,"Prosocial","screentime",8,6,6,6,6,0,0,2,4,2,"younger","1","1"
"964",126,"126",9,"Antisocial","download",4,6,6,4,4,0,0,-2,4,2,"younger","1","0"
"965",126,"126",10,"Antisocial","chargers",4,6,4,7,2,-2,-5,-2,4,2,"younger","1","0"
"966",126,"126",11,"Prosocial","homeless",8,6,8,5,5,2,0,2,4,2,"younger","1","1"
"967",127,"127",1,"Prosocial","queue",8,6,8,3,5,2,2,2,3,1,"younger","1","1"
"968",127,"127",3,"Prosocial","homeless",8,6,7,1,4,1,3,2,3,1,"younger","1","1"
"969",127,"127",5,"Antisocial","lights",5,7,4,6,2,-3,-4,-2,3,1,"younger","1","0"
"970",127,"127",6,"Prosocial","bike",9,7,8,1,5,1,4,2,3,1,"younger","1","1"
"971",127,"127",9,"Antisocial","shower",4,6,4,7,2,-2,-5,-2,3,1,"younger","1","0"
"972",127,"127",10,"Antisocial","noisedisturbance",1,3,1,5,1,-2,-4,-2,3,1,"younger","1","0"
"973",127,"127",11,"Antisocial","chargers",3,5,3,7,2,-2,-5,-2,3,1,"younger","1","0"
"974",127,"127",12,"Prosocial","screentime",9,7,9,6,5,2,-1,2,3,1,"younger","1","1"
"975",128,"128",1,"Prosocial","lendMoney",9,7,7,2,5,0,3,2,2,2,"younger","1","1"
"976",128,"128",3,"Prosocial","charity",11,9,10,5,4,1,-1,2,2,2,"younger","1","1"
"977",128,"128",4,"Antisocial","redlights",2,4,7,3,3,3,0,-2,2,2,"younger","1","0"
"978",128,"128",6,"Prosocial","homeless",11,9,10,4,4,1,0,2,2,2,"younger","1","1"
"979",128,"128",7,"Prosocial","vegetarian",10,8,10,3,3,2,0,2,2,2,"younger","1","1"
"980",128,"128",10,"Antisocial","download",3,5,8,4,4,3,0,-2,2,2,"younger","1","0"
"981",128,"128",11,"Antisocial","coughelbow",1,3,2,2,2,-1,0,-2,2,2,"younger","1","0"
"982",128,"128",12,"Antisocial","lights",4,6,5,2,5,-1,3,-2,2,2,"younger","1","0"
"983",129,"129",1,"Antisocial","chargers",5,7,5,6,4,-2,-2,-2,7,1,"younger","1","0"
"984",129,"129",3,"Prosocial","homeless",9,7,8,2,4,1,2,2,7,1,"younger","1","1"
"985",129,"129",4,"Prosocial","charity",10,8,9,4,7,1,3,2,7,1,"younger","1","1"
"986",129,"129",5,"Prosocial","seatBus",8,6,8,2,5,2,3,2,7,1,"younger","1","1"
"987",129,"129",7,"Prosocial","speed",7,5,6,4,6,1,2,2,7,1,"younger","1","1"
"988",129,"129",9,"Antisocial","distance",9,11,11,7,7,0,0,-2,7,1,"younger","1","0"
"989",129,"129",10,"Antisocial","gathering",3,5,3,2,2,-2,0,-2,7,1,"younger","1","0"
"990",129,"129",12,"Antisocial","meat",6,8,6,6,6,-2,0,-2,7,1,"younger","1","0"
"991",130,"130",2,"Antisocial","redlights",2,4,1,2,2,-3,0,-2,5,1,"younger","1","0"
"992",130,"130",3,"Antisocial","distance",2,4,1,4,1,-3,-3,-2,5,1,"younger","1","0"
"993",130,"130",4,"Prosocial","recycle",9,7,8,5,6,1,1,2,5,1,"younger","1","1"
"994",130,"130",6,"Antisocial","noisedisturbance",1,3,1,3,1,-2,-2,-2,5,1,"younger","1","0"
"995",130,"130",9,"Prosocial","crossroad",9,7,8,3,5,1,2,2,5,1,"younger","1","1"
"996",130,"130",10,"Prosocial","bike",8,6,8,1,5,2,4,2,5,1,"younger","1","1"
"997",130,"130",11,"Prosocial","homeless",7,5,4,1,2,-1,1,2,5,1,"younger","1","1"
"998",130,"130",12,"Antisocial","chargers",4,6,8,7,5,2,-2,-2,5,1,"younger","1","0"
"999",131,"131",1,"Antisocial","shower",4,6,5,2,3,-1,1,-2,5,1,"younger","1","0"
"1000",131,"131",2,"Prosocial","queue",8,6,8,3,6,2,3,2,5,1,"younger","1","1"
"1001",131,"131",3,"Antisocial","chargers",4,6,5,7,5,-1,-2,-2,5,1,"younger","1","0"
"1002",131,"131",4,"Prosocial","volunteer",9,7,10,6,7,3,1,2,5,1,"younger","1","1"
"1003",131,"131",8,"Prosocial","homeless",8,6,7,2,3,1,1,2,5,1,"younger","1","1"
"1004",131,"131",9,"Antisocial","download",5,7,7,5,7,0,2,-2,5,1,"younger","1","0"
"1005",131,"131",10,"Prosocial","screentime",9,7,9,5,4,2,-1,2,5,1,"younger","1","1"
"1006",131,"131",11,"Antisocial","heating",4,6,5,3,1,-1,-2,-2,5,1,"younger","1","0"
"1007",132,"132",1,"Prosocial","homeless",10,8,10,3,7,2,4,2,4,1,"younger","1","1"
"1008",132,"132",2,"Prosocial","lendMoney",8,6,7,5,5,1,0,2,4,1,"younger","1","1"
"1009",132,"132",3,"Antisocial","travelticket",2,4,7,2,3,3,1,-2,4,1,"younger","1","0"
"1010",132,"132",6,"Antisocial","chargers",4,6,6,5,6,0,1,-2,4,1,"younger","1","0"
"1011",132,"132",8,"Antisocial","late",2,4,3,3,2,-1,-1,-2,4,1,"younger","1","0"
"1012",132,"132",9,"Prosocial","vegetarian",8,6,11,2,7,5,5,2,4,1,"younger","1","1"
"1013",132,"132",10,"Prosocial","speed",11,9,9,5,5,0,0,2,4,1,"younger","1","1"
"1014",132,"132",11,"Antisocial","distance",9,11,8,7,4,-3,-3,-2,4,1,"younger","1","0"
"1015",133,"133",1,"Prosocial","volunteer",10,8,8,6,6,0,0,2,4,2,"younger","1","1"
"1016",133,"133",2,"Prosocial","crossroad",9,7,11,5,7,4,2,2,4,2,"younger","1","1"
"1017",133,"133",3,"Prosocial","ownbag",10,8,11,5,7,3,2,2,4,2,"younger","1","1"
"1018",133,"133",5,"Antisocial","garbage",1,3,1,3,2,-2,-1,-2,4,2,"younger","1","0"
"1019",133,"133",7,"Antisocial","noisedisturbance",2,4,3,2,2,-1,0,-2,4,2,"younger","1","0"
"1020",133,"133",9,"Antisocial","shower",4,6,2,5,3,-4,-2,-2,4,2,"younger","1","0"
"1021",133,"133",10,"Prosocial","vegetarian",6,4,1,1,1,-3,0,2,4,2,"younger","1","1"
"1022",133,"133",11,"Antisocial","distance",9,11,7,5,5,-4,0,-2,4,2,"younger","1","0"
"1023",134,"134",1,"Prosocial","charity",10,8,9,5,6,1,1,2,4,1,"younger","1","1"
"1024",134,"134",2,"Antisocial","gathering",4,6,6,4,3,0,-1,-2,4,1,"younger","1","0"
"1025",134,"134",3,"Prosocial","sustainable",8,6,6,4,4,0,0,2,4,1,"younger","1","1"
"1026",134,"134",5,"Antisocial","shower",4,6,6,5,4,0,-1,-2,4,1,"younger","1","0"
"1027",134,"134",7,"Antisocial","meat",6,8,9,7,6,1,-1,-2,4,1,"younger","1","0"
"1028",134,"134",8,"Antisocial","taxes",2,4,2,2,2,-2,0,-2,4,1,"younger","1","0"
"1029",134,"134",9,"Prosocial","speed",9,7,9,4,4,2,0,2,4,1,"younger","1","1"
"1030",134,"134",11,"Prosocial","queue",9,7,7,4,5,0,1,2,4,1,"younger","1","1"
"1031",135,"135",1,"Prosocial","queue",7,5,6,3,4,1,1,2,5,2,"younger","1","1"
"1032",135,"135",2,"Prosocial","screentime",5,3,2,3,5,-1,2,2,5,2,"younger","1","1"
"1033",135,"135",3,"Prosocial","vegetarian",11,9,9,2,6,0,4,2,5,2,"younger","1","1"
"1034",135,"135",6,"Antisocial","meat",6,8,6,6,6,-2,0,-2,5,2,"younger","1","0"
"1035",135,"135",7,"Antisocial","late",1,3,1,2,2,-2,0,-2,5,2,"younger","1","0"
"1036",135,"135",8,"Antisocial","shower",7,9,6,6,5,-3,-1,-2,5,2,"younger","1","0"
"1037",135,"135",11,"Antisocial","chargers",4,6,6,7,6,0,-1,-2,5,2,"younger","1","0"
"1038",135,"135",12,"Prosocial","charity",11,9,11,4,7,2,3,2,5,2,"younger","1","1"
"1039",136,"136",3,"Antisocial","download",6,8,7,6,5,-1,-1,-2,5,1,"younger","1","0"
"1040",136,"136",4,"Antisocial","noisedisturbance",1,3,1,2,2,-2,0,-2,5,1,"younger","1","0"
"1041",136,"136",5,"Prosocial","bike",10,8,7,1,2,-1,1,2,5,1,"younger","1","1"
"1042",136,"136",6,"Prosocial","ownbag",11,9,10,5,5,1,0,2,5,1,"younger","1","1"
"1043",136,"136",7,"Prosocial","seatBus",11,9,10,5,6,1,1,2,5,1,"younger","1","1"
"1044",136,"136",8,"Antisocial","chargers",4,6,5,6,5,-1,-1,-2,5,1,"younger","1","0"
"1045",136,"136",9,"Prosocial","crossroad",11,9,11,5,5,2,0,2,5,1,"younger","1","1"
"1046",136,"136",12,"Antisocial","gathering",4,6,5,3,2,-1,-1,-2,5,1,"younger","1","0"
"1047",137,"137",1,"Antisocial","lights",2,4,3,6,4,-1,-2,-2,5,2,"younger","1","0"
"1048",137,"137",2,"Antisocial","chargers",4,6,4,7,4,-2,-3,-2,5,2,"younger","1","0"
"1049",137,"137",4,"Antisocial","download",4,6,7,4,7,1,3,-2,5,2,"younger","1","0"
"1050",137,"137",5,"Prosocial","queue",10,8,9,4,5,1,1,2,5,2,"younger","1","1"
"1051",137,"137",7,"Prosocial","volunteer",11,9,9,4,6,0,2,2,5,2,"younger","1","1"
"1052",137,"137",8,"Prosocial","lendMoney",9,7,8,4,4,1,0,2,5,2,"younger","1","1"
"1053",137,"137",11,"Antisocial","shower",6,8,4,7,7,-4,0,-2,5,2,"younger","1","0"
"1054",137,"137",12,"Prosocial","bike",11,9,8,1,2,-1,1,2,5,2,"younger","1","1"
"1055",138,"138",1,"Antisocial","meat",5,7,7,7,7,0,0,-2,5,2,"younger","1","0"
"1056",138,"138",2,"Antisocial","distance",6,8,8,7,6,0,-1,-2,5,2,"younger","1","0"
"1057",138,"138",4,"Prosocial","queue",11,9,10,3,5,1,2,2,5,2,"younger","1","1"
"1058",138,"138",5,"Prosocial","speed",11,9,6,1,2,-3,1,2,5,2,"younger","1","1"
"1059",138,"138",8,"Prosocial","lendMoney",6,4,2,1,2,-2,1,2,5,2,"younger","1","1"
"1060",138,"138",9,"Antisocial","gathering",3,5,6,2,3,1,1,-2,5,2,"younger","1","0"
"1061",138,"138",10,"Antisocial","lights",1,3,3,4,2,0,-2,-2,5,2,"younger","1","0"
"1062",138,"138",11,"Prosocial","charity",11,9,11,5,7,2,2,2,5,2,"younger","1","1"
"1063",139,"139",2,"Prosocial","lendMoney",11,8,2,5,1,-6,-4,3,4,2,"younger","1","1"
"1064",139,"139",5,"Antisocial","chargers",3,5,3,7,7,-2,0,-2,4,2,"younger","1","0"
"1065",139,"139",6,"Antisocial","shower",3,5,2,3,4,-3,1,-2,4,2,"younger","1","0"
"1066",139,"139",9,"Prosocial","speed",7,5,6,4,1,1,-3,2,4,2,"younger","1","1"
"1067",140,"140",3,"Antisocial","meat",8,10,11,7,7,1,0,-2,3,1,"younger","1","0"
"1068",140,"140",6,"Antisocial","distance",9,11,10,5,6,-1,1,-2,3,1,"younger","1","0"
"1069",140,"140",7,"Prosocial","ownbag",11,9,11,5,7,2,2,2,3,1,"younger","1","1"
"1070",140,"140",8,"Prosocial","bike",10,8,9,2,4,1,2,2,3,1,"younger","1","1"
"1071",140,"140",9,"Prosocial","screentime",9,7,8,5,6,1,1,2,3,1,"younger","1","1"
"1072",140,"140",10,"Antisocial","chargers",3,5,4,3,4,-1,1,-2,3,1,"younger","1","0"
"1073",140,"140",11,"Antisocial","alcoholWork",1,3,1,3,1,-2,-2,-2,3,1,"younger","1","0"
"1074",141,"141",1,"Antisocial","travelticket",5,7,6,3,5,-1,2,-2,6,2,"younger","1","0"
"1075",141,"141",3,"Prosocial","seatBus",10,8,10,1,6,2,5,2,6,2,"younger","1","1"
"1076",141,"141",4,"Antisocial","chargers",9,11,11,7,7,0,0,-2,6,2,"younger","1","0"
"1077",141,"141",5,"Prosocial","volunteer",9,7,3,2,2,-4,0,2,6,2,"younger","1","1"
"1078",141,"141",6,"Antisocial","download",5,7,8,4,6,1,2,-2,6,2,"younger","1","0"
"1079",141,"141",8,"Prosocial","speed",6,4,5,1,3,1,2,2,6,2,"younger","1","1"
"1080",141,"141",9,"Antisocial","lights",2,4,2,5,1,-2,-4,-2,6,2,"younger","1","0"
"1081",141,"141",10,"Prosocial","charity",10,8,8,3,5,0,2,2,6,2,"younger","1","1"
"1082",142,"142",1,"Antisocial","download",6,8,9,6,5,1,-1,-2,5,2,"younger","1","0"
"1083",142,"142",2,"Prosocial","vegetarian",8,6,10,4,5,4,1,2,5,2,"younger","1","1"
"1084",142,"142",3,"Antisocial","meat",7,9,11,7,6,2,-1,-2,5,2,"younger","1","0"
"1085",142,"142",4,"Prosocial","lendMoney",11,9,8,5,6,-1,1,2,5,2,"younger","1","1"
"1086",142,"142",5,"Antisocial","shower",4,6,7,5,4,1,-1,-2,5,2,"younger","1","0"
"1087",142,"142",6,"Antisocial","chargers",4,6,5,7,4,-1,-3,-2,5,2,"younger","1","0"
"1088",142,"142",9,"Prosocial","queue",8,6,9,6,6,3,0,2,5,2,"younger","1","1"
"1089",143,"143",1,"Prosocial","screentime",8,6,7,1,4,1,3,2,6,2,"younger","1","1"
"1090",143,"143",2,"Antisocial","distance",4,6,6,7,4,0,-3,-2,6,2,"younger","1","0"
"1091",143,"143",4,"Antisocial","heating",4,6,10,7,4,4,-3,-2,6,2,"younger","1","0"
"1092",143,"143",5,"Prosocial","charity",10,8,10,6,6,2,0,2,6,2,"younger","1","1"
"1093",143,"143",7,"Prosocial","ownbag",10,8,11,4,7,3,3,2,6,2,"younger","1","1"
"1094",143,"143",8,"Antisocial","shower",9,11,10,7,6,-1,-1,-2,6,2,"younger","1","0"
"1095",143,"143",10,"Antisocial","meat",9,11,9,7,6,-2,-1,-2,6,2,"younger","1","0"
"1096",143,"143",11,"Prosocial","lendMoney",9,7,9,4,6,2,2,2,6,2,"younger","1","1"
"1097",144,"144",1,"Prosocial","seatBus",10,8,7,5,5,-1,0,2,5,1,"younger","1","1"
"1098",144,"144",4,"Antisocial","taxes",2,4,1,3,1,-3,-2,-2,5,1,"younger","1","0"
"1099",144,"144",5,"Antisocial","redlights",2,4,4,2,2,0,0,-2,5,1,"younger","1","0"
"1100",144,"144",6,"Prosocial","ownbag",9,7,7,5,5,0,0,2,5,1,"younger","1","1"
"1101",144,"144",7,"Antisocial","travelticket",1,3,3,3,2,0,-1,-2,5,1,"younger","1","0"
"1102",144,"144",8,"Prosocial","volunteer",10,8,6,5,5,-2,0,2,5,1,"younger","1","1"
"1103",144,"144",11,"Antisocial","noisedisturbance",1,3,4,2,2,1,0,-2,5,1,"younger","1","0"
"1104",144,"144",12,"Prosocial","homeless",9,7,9,5,6,2,1,2,5,1,"younger","1","1"
"1105",145,"145",1,"Prosocial","recycle",10,8,9,2,6,1,4,2,4,1,"younger","1","1"
"1106",145,"145",2,"Antisocial","shower",4,6,6,6,3,0,-3,-2,4,1,"younger","1","0"
"1107",145,"145",4,"Prosocial","screentime",8,6,7,5,6,1,1,2,4,1,"younger","1","1"
"1108",145,"145",5,"Antisocial","distance",1,3,1,2,1,-2,-1,-2,4,1,"younger","1","0"
"1109",145,"145",9,"Prosocial","sustainable",8,6,7,4,5,1,1,2,4,1,"younger","1","1"
"1110",145,"145",10,"Antisocial","download",2,4,2,3,2,-2,-1,-2,4,1,"younger","1","0"
"1111",145,"145",11,"Prosocial","vegetarian",8,6,6,4,4,0,0,2,4,1,"younger","1","1"
"1112",145,"145",12,"Antisocial","meat",6,8,7,7,6,-1,-1,-2,4,1,"younger","1","0"
"1113",146,"146",1,"Antisocial","noisedisturbance",2,4,4,2,3,0,1,-2,3,2,"younger","1","0"
"1114",146,"146",2,"Antisocial","download",2,4,4,2,4,0,2,-2,3,2,"younger","1","0"
"1115",146,"146",3,"Antisocial","gathering",2,4,6,3,4,2,1,-2,3,2,"younger","1","0"
"1116",146,"146",4,"Prosocial","crossroad",10,8,9,2,2,1,0,2,3,2,"younger","1","1"
"1117",146,"146",5,"Prosocial","charity",10,8,11,6,6,3,0,2,3,2,"younger","1","1"
"1118",146,"146",6,"Prosocial","bike",10,8,6,1,2,-2,1,2,3,2,"younger","1","1"
"1119",146,"146",7,"Prosocial","facemask",11,9,7,5,5,-2,0,2,3,2,"younger","1","1"
"1120",146,"146",9,"Antisocial","chargers",4,6,6,6,6,0,0,-2,3,2,"younger","1","0"
"1121",147,"147",1,"Prosocial","lendMoney",9,7,8,5,5,1,0,2,3,2,"younger","1","1"
"1122",147,"147",3,"Prosocial","queue",8,6,6,4,4,0,0,2,3,2,"younger","1","1"
"1123",147,"147",7,"Antisocial","meat",9,11,9,5,5,-2,0,-2,3,2,"younger","1","0"
"1124",147,"147",11,"Antisocial","distance",9,11,8,6,5,-3,-1,-2,3,2,"younger","1","0"
"1125",148,"148",1,"Antisocial","chargers",3,5,4,7,3,-1,-4,-2,5,1,"younger","1","0"
"1126",148,"148",3,"Prosocial","volunteer",11,9,10,1,2,1,1,2,5,1,"younger","1","1"
"1127",148,"148",4,"Prosocial","homeless",11,9,7,2,1,-2,-1,2,5,1,"younger","1","1"
"1128",148,"148",7,"Antisocial","coughelbow",1,3,1,3,1,-2,-2,-2,5,1,"younger","1","0"
"1129",148,"148",8,"Antisocial","redlights",3,5,2,5,3,-3,-2,-2,5,1,"younger","1","0"
"1130",148,"148",9,"Prosocial","speed",10,8,10,5,7,2,2,2,5,1,"younger","1","1"
"1131",148,"148",11,"Antisocial","shower",3,5,5,7,6,0,-1,-2,5,1,"younger","1","0"
"1132",148,"148",12,"Prosocial","bike",10,8,8,1,2,0,1,2,5,1,"younger","1","1"
"1133",149,"149",1,"Prosocial","sustainable",11,9,8,5,5,-1,0,2,2,1,"younger","1","1"
"1134",149,"149",2,"Antisocial","heating",3,5,2,2,2,-3,0,-2,2,1,"younger","1","0"
"1135",149,"149",3,"Prosocial","charity",11,9,10,5,7,1,2,2,2,1,"younger","1","1"
"1136",149,"149",4,"Prosocial","vegetarian",10,8,7,6,5,-1,-1,2,2,1,"younger","1","1"
"1137",149,"149",6,"Antisocial","garbage",3,5,3,5,1,-2,-4,-2,2,1,"younger","1","0"
"1138",149,"149",8,"Prosocial","crossroad",11,9,8,2,4,-1,2,2,2,1,"younger","1","1"
"1139",149,"149",9,"Antisocial","distance",1,3,1,7,1,-2,-6,-2,2,1,"younger","1","0"
"1140",149,"149",10,"Antisocial","shower",4,6,6,7,5,0,-2,-2,2,1,"younger","1","0"
"1141",150,"150",1,"Prosocial","queue",11,9,10,4,5,1,1,2,5,2,"younger","1","1"
"1142",150,"150",2,"Prosocial","homeless",10,8,9,4,6,1,2,2,5,2,"younger","1","1"
"1143",150,"150",3,"Prosocial","volunteer",11,9,11,5,6,2,1,2,5,2,"younger","1","1"
"1144",150,"150",5,"Antisocial","heating",4,6,10,3,3,4,0,-2,5,2,"younger","1","0"
"1145",150,"150",6,"Prosocial","ownbag",10,8,9,5,6,1,1,2,5,2,"younger","1","1"
"1146",150,"150",10,"Antisocial","late",1,3,2,6,6,-1,0,-2,5,2,"younger","1","0"
"1147",150,"150",11,"Antisocial","shower",5,7,8,7,6,1,-1,-2,5,2,"younger","1","0"
"1148",150,"150",12,"Antisocial","lights",4,6,4,4,3,-2,-1,-2,5,2,"younger","1","0"
"1149",151,"151",2,"Antisocial","lights",4,6,3,2,3,-3,1,-2,4,2,"younger","1","0"
"1150",151,"151",3,"Prosocial","ownbag",8,6,10,3,5,4,2,2,4,2,"younger","1","1"
"1151",151,"151",4,"Antisocial","shower",4,6,3,7,7,-3,0,-2,4,2,"younger","1","0"
"1152",151,"151",7,"Prosocial","volunteer",10,8,8,5,5,0,0,2,4,2,"younger","1","1"
"1153",151,"151",8,"Antisocial","distance",9,11,10,7,6,-1,-1,-2,4,2,"younger","1","0"
"1154",151,"151",9,"Antisocial","redlights",1,3,1,4,3,-2,-1,-2,4,2,"younger","1","0"
"1155",151,"151",10,"Prosocial","lendMoney",9,7,9,4,5,2,1,2,4,2,"younger","1","1"
"1156",151,"151",11,"Prosocial","vegetarian",8,6,8,2,4,2,2,2,4,2,"younger","1","1"
"1157",152,"152",1,"Prosocial","crossroad",10,8,10,1,5,2,4,2,3,1,"younger","1","1"
"1158",152,"152",2,"Antisocial","late",3,5,4,2,1,-1,-1,-2,3,1,"younger","1","0"
"1159",152,"152",3,"Prosocial","lendMoney",8,6,4,2,1,-2,-1,2,3,1,"younger","1","1"
"1160",152,"152",4,"Antisocial","chargers",4,6,6,7,3,0,-4,-2,3,1,"younger","1","0"
"1161",152,"152",5,"Antisocial","shower",3,5,5,6,5,0,-1,-2,3,1,"younger","1","0"
"1162",152,"152",6,"Prosocial","sustainable",9,7,9,4,5,2,1,2,3,1,"younger","1","1"
"1163",152,"152",7,"Prosocial","speed",8,6,8,3,6,2,3,2,3,1,"younger","1","1"
"1164",152,"152",8,"Antisocial","distance",8,10,11,7,7,1,0,-2,3,1,"younger","1","0"
"1165",153,"153",1,"Antisocial","noisedisturbance",4,6,6,5,4,0,-1,-2,6,2,"younger","1","0"
"1166",153,"153",2,"Prosocial","homeless",10,8,11,5,6,3,1,2,6,2,"younger","1","1"
"1167",153,"153",3,"Prosocial","bike",10,8,9,4,3,1,-1,2,6,2,"younger","1","1"
"1168",153,"153",5,"Antisocial","gathering",4,6,6,5,5,0,0,-2,6,2,"younger","1","0"
"1169",153,"153",6,"Antisocial","redlights",2,4,4,4,4,0,0,-2,6,2,"younger","1","0"
"1170",153,"153",9,"Prosocial","charity",10,8,11,5,5,3,0,2,6,2,"younger","1","1"
"1171",153,"153",10,"Prosocial","queue",10,8,8,3,2,0,-1,2,6,2,"younger","1","1"
"1172",153,"153",12,"Antisocial","alcoholWork",2,4,2,5,2,-2,-3,-2,6,2,"younger","1","0"
"1173",154,"154",1,"Prosocial","sustainable",11,9,6,4,5,-3,1,2,3,1,"younger","1","1"
"1174",154,"154",3,"Antisocial","distance",4,6,6,4,4,0,0,-2,3,1,"younger","1","0"
"1175",154,"154",4,"Prosocial","homeless",8,6,7,4,5,1,1,2,3,1,"younger","1","1"
"1176",154,"154",5,"Antisocial","shower",4,6,7,5,5,1,0,-2,3,1,"younger","1","0"
"1177",154,"154",6,"Antisocial","alcoholWork",5,7,3,5,3,-4,-2,-2,3,1,"younger","1","0"
"1178",154,"154",7,"Prosocial","lendMoney",8,6,8,1,6,2,5,2,3,1,"younger","1","1"
"1179",154,"154",8,"Prosocial","recycle",11,9,7,4,5,-2,1,2,3,1,"younger","1","1"
"1180",154,"154",12,"Antisocial","travelticket",4,6,6,2,4,0,2,-2,3,1,"younger","1","0"
"1181",155,"155",1,"Prosocial","lendMoney",8,6,6,2,4,0,2,2,1,2,"younger","1","1"
"1182",155,"155",2,"Prosocial","seatBus",9,7,9,4,7,2,3,2,1,2,"younger","1","1"
"1183",155,"155",4,"Prosocial","crossroad",8,6,7,5,5,1,0,2,1,2,"younger","1","1"
"1184",155,"155",6,"Antisocial","meat",9,11,6,7,7,-5,0,-2,1,2,"younger","1","0"
"1185",155,"155",7,"Prosocial","queue",8,6,7,5,6,1,1,2,1,2,"younger","1","1"
"1186",155,"155",8,"Antisocial","heating",4,6,3,2,1,-3,-1,-2,1,2,"younger","1","0"
"1187",155,"155",9,"Antisocial","shower",3,5,4,2,2,-1,0,-2,1,2,"younger","1","0"
"1188",155,"155",11,"Antisocial","download",6,8,6,2,1,-2,-1,-2,1,2,"younger","1","0"
"1189",156,"156",1,"Antisocial","late",4,6,4,2,3,-2,1,-2,3,1,"younger","1","0"
"1190",156,"156",2,"Prosocial","vegetarian",10,8,9,2,5,1,3,2,3,1,"younger","1","1"
"1191",156,"156",3,"Prosocial","homeless",10,8,9,1,3,1,2,2,3,1,"younger","1","1"
"1192",156,"156",4,"Prosocial","bike",11,9,9,1,1,0,0,2,3,1,"younger","1","1"
"1193",156,"156",6,"Antisocial","distance",4,6,6,7,6,0,-1,-2,3,1,"younger","1","0"
"1194",156,"156",8,"Antisocial","chargers",4,6,6,7,7,0,0,-2,3,1,"younger","1","0"
"1195",156,"156",10,"Antisocial","noisedisturbance",4,6,3,2,2,-3,0,-2,3,1,"younger","1","0"
"1196",156,"156",12,"Prosocial","crossroad",11,9,10,5,6,1,1,2,3,1,"younger","1","1"
"1197",157,"157",1,"Antisocial","shower",7,9,9,7,5,0,-2,-2,6,2,"younger","1","0"
"1198",157,"157",3,"Prosocial","lendMoney",8,6,7,1,4,1,3,2,6,2,"younger","1","1"
"1199",157,"157",5,"Antisocial","travelticket",1,3,1,1,1,-2,0,-2,6,2,"younger","1","0"
"1200",157,"157",6,"Prosocial","homeless",6,4,6,1,4,2,3,2,6,2,"younger","1","1"
"1201",157,"157",7,"Antisocial","heating",1,6,1,1,2,-5,1,-5,6,2,"younger","1","0"
"1202",157,"157",8,"Antisocial","late",2,4,1,2,2,-3,0,-2,6,2,"younger","1","0"
"1203",157,"157",10,"Prosocial","bike",9,7,11,1,3,4,2,2,6,2,"younger","1","1"
"1204",157,"157",11,"Prosocial","washands",11,9,8,6,7,-1,1,2,6,2,"younger","1","1"
"1205",157,"157",12,"Antisocial","meat",9,11,10,7,5,-1,-2,-2,6,2,"younger","1","0"
"1206",158,"158",2,"Antisocial","shower",3,5,4,5,4,-1,-1,-2,5,2,"younger","1","0"
"1207",158,"158",4,"Prosocial","lendMoney",8,6,10,4,5,4,1,2,5,2,"younger","1","1"
"1208",158,"158",5,"Prosocial","speed",11,9,11,6,7,2,1,2,5,2,"younger","1","1"
"1209",158,"158",8,"Antisocial","late",1,3,3,5,3,0,-2,-2,5,2,"younger","1","0"
"1210",158,"158",9,"Antisocial","parking",2,4,1,2,1,-3,-1,-2,5,2,"younger","1","0"
"1211",158,"158",10,"Prosocial","seatBus",11,9,11,4,7,2,3,2,5,2,"younger","1","1"
"1212",158,"158",11,"Antisocial","chargers",3,5,4,4,4,-1,0,-2,5,2,"younger","1","0"
"1213",158,"158",12,"Prosocial","volunteer",10,8,11,5,7,3,2,2,5,2,"younger","1","1"
"1214",159,"159",1,"Antisocial","chargers",4,6,5,3,3,-1,0,-2,6,2,"younger","1","0"
"1215",159,"159",3,"Prosocial","volunteer",11,9,10,2,7,1,5,2,6,2,"younger","1","1"
"1216",159,"159",5,"Antisocial","late",1,3,4,3,3,1,0,-2,6,2,"younger","1","0"
"1217",159,"159",6,"Antisocial","distance",8,10,1,7,1,-9,-6,-2,6,2,"younger","1","0"
"1218",159,"159",7,"Antisocial","download",4,6,7,4,6,1,2,-2,6,2,"younger","1","0"
"1219",159,"159",8,"Prosocial","lendMoney",11,9,11,5,7,2,2,2,6,2,"younger","1","1"
"1220",159,"159",9,"Prosocial","bike",11,9,11,1,4,2,3,2,6,2,"younger","1","1"
"1221",159,"159",11,"Prosocial","screentime",11,9,10,6,6,1,0,2,6,2,"younger","1","1"
"1222",160,"160",1,"Prosocial","homeless",11,9,9,2,4,0,2,2,4,1,"younger","1","1"
"1223",160,"160",2,"Prosocial","queue",11,9,6,4,4,-3,0,2,4,1,"younger","1","1"
"1224",160,"160",4,"Antisocial","shower",1,3,2,4,2,-1,-2,-2,4,1,"younger","1","0"
"1225",160,"160",6,"Antisocial","parking",4,6,1,6,1,-5,-5,-2,4,1,"younger","1","0"
"1226",160,"160",7,"Prosocial","screentime",8,6,10,2,3,4,1,2,4,1,"younger","1","1"
"1227",160,"160",8,"Antisocial","distance",2,4,1,5,2,-3,-3,-2,4,1,"younger","1","0"
"1228",160,"160",9,"Antisocial","redlights",1,3,1,4,1,-2,-3,-2,4,1,"younger","1","0"
"1229",160,"160",11,"Prosocial","lendMoney",8,6,6,1,3,0,2,2,4,1,"younger","1","1"
"1230",161,"161",1,"Prosocial","screentime",8,6,6,3,3,0,0,2,6,2,"younger","1","1"
"1231",161,"161",2,"Prosocial","speed",8,6,8,3,3,2,0,2,6,2,"younger","1","1"
"1232",161,"161",3,"Prosocial","lendMoney",9,7,9,1,5,2,4,2,6,2,"younger","1","1"
"1233",161,"161",5,"Antisocial","noisedisturbance",1,4,1,1,1,-3,0,-3,6,2,"younger","1","0"
"1234",161,"161",6,"Antisocial","late",1,3,3,1,2,0,1,-2,6,2,"younger","1","0"
"1235",161,"161",8,"Antisocial","shower",4,6,6,7,6,0,-1,-2,6,2,"younger","1","0"
"1236",161,"161",11,"Antisocial","alcoholWork",4,6,6,2,4,0,2,-2,6,2,"younger","1","0"
"1237",161,"161",12,"Prosocial","bike",11,9,8,2,2,-1,0,2,6,2,"younger","1","1"
"1238",162,"162",2,"Prosocial","ownbag",11,9,11,4,7,2,3,2,4,1,"younger","1","1"
"1239",162,"162",3,"Antisocial","travelticket",4,6,6,2,4,0,2,-2,4,1,"younger","1","0"
"1240",162,"162",4,"Prosocial","vegetarian",8,6,3,1,4,-3,3,2,4,1,"younger","1","1"
"1241",162,"162",5,"Antisocial","heating",1,3,1,2,1,-2,-1,-2,4,1,"younger","1","0"
"1242",162,"162",7,"Prosocial","charity",8,6,6,1,2,0,1,2,4,1,"younger","1","1"
"1243",162,"162",8,"Antisocial","cyberbully",3,5,6,3,3,1,0,-2,4,1,"younger","1","0"
"1244",162,"162",9,"Prosocial","homeless",11,9,9,4,3,0,-1,2,4,1,"younger","1","1"
"1245",162,"162",11,"Antisocial","shower",4,6,9,6,5,3,-1,-2,4,1,"younger","1","0"
"1246",163,"163",1,"Antisocial","shower",3,5,3,7,7,-2,0,-2,4,2,"younger","1","0"
"1247",163,"163",2,"Antisocial","heating",4,6,5,4,1,-1,-3,-2,4,2,"younger","1","0"
"1248",163,"163",3,"Prosocial","speed",9,7,11,2,3,4,1,2,4,2,"younger","1","1"
"1249",163,"163",4,"Prosocial","lendMoney",8,6,3,4,1,-3,-3,2,4,2,"younger","1","1"
"1250",163,"163",7,"Prosocial","queue",11,9,7,5,5,-2,0,2,4,2,"younger","1","1"
"1251",163,"163",8,"Antisocial","late",3,5,6,3,7,1,4,-2,4,2,"younger","1","0"
"1252",163,"163",9,"Prosocial","sustainable",11,9,10,5,6,1,1,2,4,2,"younger","1","1"
"1253",163,"163",10,"Antisocial","chargers",4,6,5,7,7,-1,0,-2,4,2,"younger","1","0"
"1254",164,"164",3,"Antisocial","meat",9,11,10,7,7,-1,0,-2,6,2,"younger","1","0"
"1255",164,"164",6,"Antisocial","download",7,9,6,7,5,-3,-2,-2,6,2,"younger","1","0"
"1256",164,"164",7,"Prosocial","speed",8,6,8,4,4,2,0,2,6,2,"younger","1","1"
"1257",164,"164",8,"Prosocial","sustainable",8,6,6,4,4,0,0,2,6,2,"younger","1","1"
"1258",164,"164",9,"Antisocial","travelticket",6,8,6,7,4,-2,-3,-2,6,2,"younger","1","0"
"1259",164,"164",10,"Antisocial","chargers",9,11,7,6,7,-4,1,-2,6,2,"younger","1","0"
"1260",164,"164",11,"Prosocial","organicVegetables",8,6,11,4,7,5,3,2,6,2,"younger","1","1"
"1261",164,"164",12,"Prosocial","queue",10,8,10,5,5,2,0,2,6,2,"younger","1","1"
"1262",165,"165",1,"Prosocial","vegetarian",9,7,8,3,2,1,-1,2,4,1,"younger","1","1"
"1263",165,"165",2,"Antisocial","lights",5,7,7,6,6,0,0,-2,4,1,"younger","1","0"
"1264",165,"165",3,"Prosocial","volunteer",9,7,10,1,2,3,1,2,4,1,"younger","1","1"
"1265",165,"165",5,"Antisocial","chargers",5,7,3,7,6,-4,-1,-2,4,1,"younger","1","0"
"1266",165,"165",6,"Antisocial","distance",9,11,9,7,7,-2,0,-2,4,1,"younger","1","0"
"1267",165,"165",7,"Prosocial","queue",4,2,3,1,1,1,0,2,4,1,"younger","1","1"
"1268",165,"165",10,"Antisocial","meat",7,9,9,7,7,0,0,-2,4,1,"younger","1","0"
"1269",165,"165",11,"Prosocial","bike",7,5,8,1,1,3,0,2,4,1,"younger","1","1"
"1270",166,"166",1,"Prosocial","crossroad",8,6,2,1,4,-4,3,2,5,2,"younger","1","1"
"1271",166,"166",2,"Prosocial","lendMoney",4,2,1,1,1,-1,0,2,5,2,"younger","1","1"
"1272",166,"166",3,"Antisocial","distance",4,6,11,7,7,5,0,-2,5,2,"younger","1","0"
"1273",166,"166",4,"Antisocial","meat",9,11,9,7,5,-2,-2,-2,5,2,"younger","1","0"
"1274",166,"166",6,"Antisocial","download",8,11,8,6,6,-3,0,-3,5,2,"younger","1","0"
"1275",166,"166",8,"Prosocial","homeless",5,1,2,1,2,1,1,4,5,2,"younger","1","1"
"1276",166,"166",10,"Antisocial","chargers",9,11,10,7,7,-1,0,-2,5,2,"younger","1","0"
"1277",166,"166",11,"Prosocial","queue",3,1,2,1,2,1,1,2,5,2,"younger","1","1"
"1278",167,"167",1,"Prosocial","queue",6,4,6,4,3,2,-1,2,5,1,"younger","1","1"
"1279",167,"167",2,"Prosocial","speed",11,9,11,4,6,2,2,2,5,1,"younger","1","1"
"1280",167,"167",3,"Prosocial","lendMoney",6,4,6,3,2,2,-1,2,5,1,"younger","1","1"
"1281",167,"167",5,"Antisocial","heating",4,6,4,2,1,-2,-1,-2,5,1,"younger","1","0"
"1282",167,"167",6,"Antisocial","download",4,6,8,5,4,2,-1,-2,5,1,"younger","1","0"
"1283",167,"167",10,"Prosocial","screentime",8,6,6,3,2,0,-1,2,5,1,"younger","1","1"
"1284",167,"167",11,"Antisocial","late",4,6,4,4,2,-2,-2,-2,5,1,"younger","1","0"
"1285",167,"167",12,"Antisocial","chargers",4,6,5,6,5,-1,-1,-2,5,1,"younger","1","0"
"1286",168,"168",1,"Antisocial","late",1,3,1,2,1,-2,-1,-2,6,2,"younger","1","0"
"1287",168,"168",2,"Prosocial","vegetarian",6,4,6,2,2,2,0,2,6,2,"younger","1","1"
"1288",168,"168",3,"Antisocial","gathering",2,4,2,2,2,-2,0,-2,6,2,"younger","1","0"
"1289",168,"168",4,"Antisocial","meat",7,9,8,7,6,-1,-1,-2,6,2,"younger","1","0"
"1290",168,"168",7,"Prosocial","volunteer",9,7,9,2,5,2,3,2,6,2,"younger","1","1"
"1291",168,"168",9,"Prosocial","crossroad",11,9,9,2,4,0,2,2,6,2,"younger","1","1"
"1292",168,"168",10,"Antisocial","lights",1,3,2,3,2,-1,-1,-2,6,2,"younger","1","0"
"1293",168,"168",12,"Prosocial","charity",11,9,10,4,6,1,2,2,6,2,"younger","1","1"
"1294",169,"169",1,"Prosocial","homeless",10,8,9,4,3,1,-1,2,4,1,"younger","1","1"
"1295",169,"169",3,"Antisocial","meat",7,9,8,7,6,-1,-1,-2,4,1,"younger","1","0"
"1296",169,"169",4,"Antisocial","distance",6,8,7,6,6,-1,0,-2,4,1,"younger","1","0"
"1297",169,"169",7,"Prosocial","speed",11,9,10,4,6,1,2,2,4,1,"younger","1","1"
"1298",169,"169",8,"Prosocial","queue",6,4,5,2,2,1,0,2,4,1,"younger","1","1"
"1299",169,"169",11,"Antisocial","download",6,8,6,6,5,-2,-1,-2,4,1,"younger","1","0"
"1300",169,"169",12,"Antisocial","gathering",5,7,5,5,3,-2,-2,-2,4,1,"younger","1","0"
"1301",1,"170",1,"Prosocial","vaccination",9,7,9,4,6,2,2,2,3,2,"older","0","1"
"1302",1,"170",3,"Prosocial","lendMoney",9,7,7,5,4,0,-1,2,3,2,"older","0","1"
"1303",1,"170",5,"Antisocial","coughelbow",1,3,4,2,3,1,1,-2,3,2,"older","0","0"
"1304",1,"170",7,"Antisocial","gathering",4,6,6,3,4,0,1,-2,3,2,"older","0","0"
"1305",1,"170",8,"Prosocial","screentime",8,6,7,3,4,1,1,2,3,2,"older","0","1"
"1306",1,"170",9,"Prosocial","queue",10,8,9,5,5,1,0,2,3,2,"older","0","1"
"1307",1,"170",10,"Antisocial","lights",3,5,5,3,4,0,1,-2,3,2,"older","0","0"
"1308",1,"170",12,"Antisocial","distance",4,6,5,4,3,-1,-1,-2,3,2,"older","0","0"
"1309",2,"171",3,"Antisocial","garbage",2,4,5,3,4,1,1,-2,2,2,"older","0","0"
"1310",2,"171",4,"Antisocial","noisedisturbance",4,6,7,7,5,1,-2,-2,2,2,"older","0","0"
"1311",2,"171",5,"Antisocial","gathering",5,7,6,6,2,-1,-4,-2,2,2,"older","0","0"
"1312",2,"171",6,"Antisocial","distance",9,11,10,5,6,-1,1,-2,2,2,"older","0","0"
"1313",2,"171",7,"Prosocial","vaccination",10,8,9,4,5,1,1,2,2,2,"older","0","1"
"1314",2,"171",8,"Prosocial","charity",11,9,11,1,2,2,1,2,2,2,"older","0","1"
"1315",3,"172",1,"Antisocial","distance",6,8,4,6,5,-4,-1,-2,4,1,"older","0","0"
"1316",3,"172",3,"Prosocial","organicVegetables",8,6,6,5,4,0,-1,2,4,1,"older","0","1"
"1317",3,"172",4,"Prosocial","bike",9,7,6,1,2,-1,1,2,4,1,"older","0","1"
"1318",3,"172",5,"Prosocial","seatBus",8,6,6,4,4,0,0,2,4,1,"older","0","1"
"1319",3,"172",7,"Antisocial","gathering",3,5,4,4,2,-1,-2,-2,4,1,"older","0","0"
"1320",3,"172",8,"Prosocial","screentime",8,6,6,4,6,0,2,2,4,1,"older","0","1"
"1321",3,"172",11,"Antisocial","shower",4,6,6,4,4,0,0,-2,4,1,"older","0","0"
"1322",3,"172",12,"Antisocial","chargers",4,6,6,5,5,0,0,-2,4,1,"older","0","0"
"1323",4,"173",1,"Antisocial","gathering",2,4,3,3,3,-1,0,-2,5,2,"older","0","0"
"1324",4,"173",2,"Prosocial","homeless",7,5,5,1,3,0,2,2,5,2,"older","0","1"
"1325",4,"173",3,"Antisocial","chargers",4,6,5,6,5,-1,-1,-2,5,2,"older","0","0"
"1326",4,"173",4,"Prosocial","lendMoney",9,7,7,1,2,0,1,2,5,2,"older","0","1"
"1327",4,"173",6,"Prosocial","queue",10,8,10,3,6,2,3,2,5,2,"older","0","1"
"1328",4,"173",9,"Prosocial","bike",10,8,9,1,3,1,2,2,5,2,"older","0","1"
"1329",4,"173",10,"Antisocial","redlights",2,4,2,2,1,-2,-1,-2,5,2,"older","0","0"
"1330",4,"173",11,"Antisocial","late",3,5,4,2,2,-1,0,-2,5,2,"older","0","0"
"1331",5,"174",1,"Prosocial","volunteer",10,8,9,4,5,1,1,2,2,2,"older","0","1"
"1332",5,"174",2,"Antisocial","gathering",4,6,3,4,2,-3,-2,-2,2,2,"older","0","0"
"1333",5,"174",5,"Prosocial","ownbag",11,9,9,4,6,0,2,2,2,2,"older","0","1"
"1334",5,"174",7,"Antisocial","shower",4,6,5,7,4,-1,-3,-2,2,2,"older","0","0"
"1335",5,"174",8,"Antisocial","lights",3,5,2,5,1,-3,-4,-2,2,2,"older","0","0"
"1336",5,"174",9,"Prosocial","bike",9,7,8,4,5,1,1,2,2,2,"older","0","1"
"1337",5,"174",10,"Antisocial","distance",8,10,8,5,5,-2,0,-2,2,2,"older","0","0"
"1338",5,"174",12,"Prosocial","homeless",10,8,9,5,6,1,1,2,2,2,"older","0","1"
"1339",6,"175",2,"Prosocial","organicVegetables",11,9,11,6,7,2,1,2,6,2,"older","0","1"
"1340",6,"175",3,"Prosocial","washands",11,9,11,6,7,2,1,2,6,2,"older","0","1"
"1341",6,"175",4,"Antisocial","distance",2,4,2,2,1,-2,-1,-2,6,2,"older","0","0"
"1342",6,"175",5,"Antisocial","coughelbow",4,6,4,3,2,-2,-1,-2,6,2,"older","0","0"
"1343",6,"175",6,"Prosocial","vegetarian",8,6,9,4,6,3,2,2,6,2,"older","0","1"
"1344",6,"175",7,"Antisocial","meat",6,8,6,6,4,-2,-2,-2,6,2,"older","0","0"
"1345",6,"175",8,"Antisocial","shower",4,6,4,4,4,-2,0,-2,6,2,"older","0","0"
"1346",6,"175",10,"Prosocial","screentime",8,6,8,3,6,2,3,2,6,2,"older","0","1"
"1347",7,"176",1,"Antisocial","heating",1,3,2,2,2,-1,0,-2,6,2,"older","0","0"
"1348",7,"176",3,"Prosocial","homeless",8,6,8,4,4,2,0,2,6,2,"older","0","1"
"1349",7,"176",5,"Prosocial","seatBus",8,6,7,4,6,1,2,2,6,2,"older","0","1"
"1350",7,"176",6,"Antisocial","coughelbow",6,8,9,4,7,1,3,-2,6,2,"older","0","0"
"1351",7,"176",7,"Prosocial","charity",8,6,7,5,4,1,-1,2,6,2,"older","0","1"
"1352",7,"176",10,"Prosocial","crossroad",8,6,8,4,4,2,0,2,6,2,"older","0","1"
"1353",7,"176",11,"Antisocial","shower",4,6,4,4,3,-2,-1,-2,6,2,"older","0","0"
"1354",7,"176",12,"Antisocial","alcoholWork",3,5,5,3,2,0,-1,-2,6,2,"older","0","0"
"1355",8,"177",1,"Prosocial","queue",11,9,9,4,6,0,2,2,2,1,"older","0","1"
"1356",8,"177",2,"Prosocial","bike",10,8,10,2,4,2,2,2,2,1,"older","0","1"
"1357",8,"177",4,"Prosocial","recycle",11,9,11,6,6,2,0,2,2,1,"older","0","1"
"1358",8,"177",5,"Antisocial","distance",8,10,9,6,7,-1,1,-2,2,1,"older","0","0"
"1359",8,"177",6,"Antisocial","gathering",2,4,2,2,1,-2,-1,-2,2,1,"older","0","0"
"1360",8,"177",7,"Prosocial","speed",11,9,11,6,7,2,1,2,2,1,"older","0","1"
"1361",8,"177",9,"Antisocial","shower",4,6,5,5,4,-1,-1,-2,2,1,"older","0","0"
"1362",8,"177",11,"Antisocial","chargers",4,6,3,5,3,-3,-2,-2,2,1,"older","0","0"
"1363",9,"178",1,"Antisocial","shower",3,5,3,2,2,-2,0,-2,5,2,"older","0","0"
"1364",9,"178",2,"Antisocial","late",2,4,2,2,1,-2,-1,-2,5,2,"older","0","0"
"1365",9,"178",4,"Prosocial","sustainable",10,8,9,1,5,1,4,2,5,2,"older","0","1"
"1366",9,"178",5,"Prosocial","charity",11,9,11,2,3,2,1,2,5,2,"older","0","1"
"1367",9,"178",6,"Antisocial","download",3,5,6,2,4,1,2,-2,5,2,"older","0","0"
"1368",9,"178",7,"Prosocial","organicVegetables",8,6,7,4,4,1,0,2,5,2,"older","0","1"
"1369",9,"178",9,"Antisocial","distance",4,6,6,5,3,0,-2,-2,5,2,"older","0","0"
"1370",9,"178",10,"Prosocial","lendMoney",8,6,7,1,1,1,0,2,5,2,"older","0","1"
"1371",10,"179",1,"Antisocial","gathering",4,6,6,7,4,0,-3,-2,4,1,"older","0","0"
"1372",10,"179",5,"Prosocial","organicVegetables",11,9,8,6,7,-1,1,2,4,1,"older","0","1"
"1373",10,"179",7,"Antisocial","coughelbow",4,6,6,2,5,0,3,-2,4,1,"older","0","0"
"1374",10,"179",8,"Prosocial","screentime",8,6,6,2,3,0,1,2,4,1,"older","0","1"
"1375",10,"179",9,"Prosocial","bike",11,9,6,1,5,-3,4,2,4,1,"older","0","1"
"1376",10,"179",10,"Prosocial","vegetarian",11,9,9,6,7,0,1,2,4,1,"older","0","1"
"1377",11,"180",1,"Prosocial","lendMoney",8,6,7,1,5,1,4,2,4,2,"older","0","1"
"1378",11,"180",2,"Prosocial","organicVegetables",10,8,9,5,6,1,1,2,4,2,"older","0","1"
"1379",11,"180",4,"Antisocial","chargers",1,3,3,7,5,0,-2,-2,4,2,"older","0","0"
"1380",11,"180",5,"Prosocial","homeless",8,6,7,4,4,1,0,2,4,2,"older","0","1"
"1381",11,"180",6,"Antisocial","gathering",2,4,2,3,2,-2,-1,-2,4,2,"older","0","0"
"1382",11,"180",8,"Antisocial","distance",9,11,9,6,6,-2,0,-2,4,2,"older","0","0"
"1383",11,"180",9,"Antisocial","heating",5,7,7,3,5,0,2,-2,4,2,"older","0","0"
"1384",11,"180",12,"Prosocial","screentime",8,6,7,2,5,1,3,2,4,2,"older","0","1"
"1385",12,"181",1,"Antisocial","meat",6,8,6,7,4,-2,-3,-2,2,2,"older","0","0"
"1386",12,"181",2,"Prosocial","lendMoney",8,6,4,4,3,-2,-1,2,2,2,"older","0","1"
"1387",12,"181",5,"Antisocial","distance",9,11,3,7,3,-8,-4,-2,2,2,"older","0","0"
"1388",12,"181",6,"Prosocial","screentime",10,8,11,1,7,3,6,2,2,2,"older","0","1"
"1389",12,"181",8,"Antisocial","shower",4,6,4,5,4,-2,-1,-2,2,2,"older","0","0"
"1390",12,"181",9,"Antisocial","lights",2,4,3,4,2,-1,-2,-2,2,2,"older","0","0"
"1391",13,"182",1,"Antisocial","coughelbow",4,6,3,2,1,-3,-1,-2,3,1,"older","0","0"
"1392",13,"182",2,"Prosocial","vaccination",7,5,2,1,1,-3,0,2,3,1,"older","0","1"
"1393",13,"182",6,"Antisocial","distance",9,11,10,7,7,-1,0,-2,3,1,"older","0","0"
"1394",13,"182",7,"Antisocial","shower",4,6,5,2,2,-1,0,-2,3,1,"older","0","0"
"1395",13,"182",8,"Prosocial","washands",8,6,6,1,2,0,1,2,3,1,"older","0","1"
"1396",13,"182",10,"Prosocial","sustainable",9,7,10,4,5,3,1,2,3,1,"older","0","1"
"1397",13,"182",11,"Prosocial","vegetarian",9,7,8,4,4,1,0,2,3,1,"older","0","1"
"1398",13,"182",12,"Antisocial","lights",4,6,5,2,2,-1,0,-2,3,1,"older","0","0"
"1399",14,"183",3,"Prosocial","facemask",8,6,6,3,4,0,1,2,3,1,"older","0","1"
"1400",14,"183",4,"Prosocial","homeless",8,6,4,2,1,-2,-1,2,3,1,"older","0","1"
"1401",14,"183",5,"Antisocial","chargers",1,4,1,2,1,-3,-1,-3,3,1,"older","0","0"
"1402",14,"183",6,"Prosocial","vaccination",8,6,6,1,1,0,0,2,3,1,"older","0","1"
"1403",14,"183",8,"Antisocial","gathering",4,6,6,2,2,0,0,-2,3,1,"older","0","0"
"1404",14,"183",9,"Antisocial","shower",4,6,6,4,5,0,1,-2,3,1,"older","0","0"
"1405",14,"183",11,"Prosocial","queue",11,9,11,4,7,2,3,2,3,1,"older","0","1"
"1406",14,"183",12,"Antisocial","coughelbow",1,3,1,2,1,-2,-1,-2,3,1,"older","0","0"
"1407",15,"184",4,"Antisocial","chargers",1,4,3,2,6,-1,4,-3,4,1,"older","0","0"
"1408",15,"184",5,"Prosocial","screentime",11,9,9,3,4,0,1,2,4,1,"older","0","1"
"1409",15,"184",6,"Prosocial","vegetarian",8,6,6,1,1,0,0,2,4,1,"older","0","1"
"1410",15,"184",9,"Prosocial","queue",11,9,10,5,7,1,2,2,4,1,"older","0","1"
"1411",15,"184",10,"Antisocial","travelticket",1,8,6,1,4,-2,3,-7,4,1,"older","0","0"
"1412",15,"184",11,"Antisocial","redlights",3,5,2,3,5,-3,2,-2,4,1,"older","0","0"
"1413",15,"184",12,"Prosocial","seatBus",11,9,10,6,5,1,-1,2,4,1,"older","0","1"
"1414",16,"185",1,"Antisocial","distance",6,8,2,2,2,-6,0,-2,5,2,"older","0","0"
"1415",16,"185",4,"Prosocial","queue",11,9,10,5,5,1,0,2,5,2,"older","0","1"
"1416",16,"185",6,"Antisocial","download",6,8,7,2,6,-1,4,-2,5,2,"older","0","0"
"1417",16,"185",7,"Antisocial","redlights",3,5,5,2,4,0,2,-2,5,2,"older","0","0"
"1418",16,"185",8,"Antisocial","shower",5,7,6,6,7,-1,1,-2,5,2,"older","0","0"
"1419",16,"185",9,"Prosocial","screentime",11,9,9,1,5,0,4,2,5,2,"older","0","1"
"1420",16,"185",11,"Prosocial","lendMoney",9,7,9,2,3,2,1,2,5,2,"older","0","1"
"1421",16,"185",12,"Prosocial","washands",9,7,11,5,6,4,1,2,5,2,"older","0","1"
"1422",17,"186",1,"Prosocial","queue",8,6,9,4,6,3,2,2,5,2,"older","0","1"
"1423",17,"186",3,"Antisocial","distance",6,9,6,7,4,-3,-3,-3,5,2,"older","0","0"
"1424",17,"186",5,"Prosocial","bike",8,6,10,1,4,4,3,2,5,2,"older","0","1"
"1425",17,"186",7,"Prosocial","organicVegetables",8,6,9,6,5,3,-1,2,5,2,"older","0","1"
"1426",17,"186",8,"Antisocial","shower",3,5,3,2,2,-2,0,-2,5,2,"older","0","0"
"1427",17,"186",9,"Antisocial","chargers",4,6,5,6,4,-1,-2,-2,5,2,"older","0","0"
"1428",17,"186",11,"Antisocial","download",3,6,6,2,5,0,3,-3,5,2,"older","0","0"
"1429",17,"186",12,"Prosocial","speed",8,6,6,1,5,0,4,2,5,2,"older","0","1"
"1430",18,"187",2,"Antisocial","alcoholWork",1,3,1,1,1,-2,0,-2,3,2,"older","0","0"
"1431",18,"187",3,"Prosocial","lendMoney",8,6,11,5,7,5,2,2,3,2,"older","0","1"
"1432",18,"187",4,"Prosocial","screentime",8,6,11,2,2,5,0,2,3,2,"older","0","1"
"1433",18,"187",5,"Antisocial","shower",7,10,11,7,7,1,0,-3,3,2,"older","0","0"
"1434",18,"187",6,"Prosocial","bike",9,7,11,1,3,4,2,2,3,2,"older","0","1"
"1435",18,"187",7,"Antisocial","gathering",6,8,1,2,2,-7,0,-2,3,2,"older","0","0"
"1436",18,"187",9,"Antisocial","chargers",4,6,6,6,5,0,-1,-2,3,2,"older","0","0"
"1437",18,"187",11,"Prosocial","queue",6,4,1,2,2,-3,0,2,3,2,"older","0","1"
"1438",18,"187",12,"Antisocial","lights",3,5,6,5,2,1,-3,-2,3,2,"older","0","0"
"1439",19,"188",2,"Prosocial","homeless",10,8,9,3,4,1,1,2,4,1,"older","0","1"
"1440",19,"188",5,"Antisocial","taxes",2,4,3,4,2,-1,-2,-2,4,1,"older","0","0"
"1441",19,"188",7,"Antisocial","chargers",4,6,6,4,5,0,1,-2,4,1,"older","0","0"
"1442",19,"188",8,"Antisocial","gathering",1,3,4,3,2,1,-1,-2,4,1,"older","0","0"
"1443",19,"188",9,"Antisocial","distance",3,5,3,5,2,-2,-3,-2,4,1,"older","0","0"
"1444",19,"188",10,"Prosocial","bike",11,9,9,2,3,0,1,2,4,1,"older","0","1"
"1445",19,"188",11,"Prosocial","seatBus",11,9,8,4,3,-1,-1,2,4,1,"older","0","1"
"1446",19,"188",12,"Prosocial","organicVegetables",10,8,8,5,6,0,1,2,4,1,"older","0","1"
"1447",20,"189",2,"Prosocial","facemask",9,7,6,4,5,-1,1,2,1,1,"older","0","1"
"1448",20,"189",3,"Prosocial","vaccination",7,5,6,1,1,1,0,2,1,1,"older","0","1"
"1449",20,"189",4,"Prosocial","sustainable",11,9,11,4,7,2,3,2,1,1,"older","0","1"
"1450",20,"189",5,"Antisocial","shower",5,7,6,4,5,-1,1,-2,1,1,"older","0","0"
"1451",20,"189",6,"Antisocial","gathering",1,3,5,4,1,2,-3,-2,1,1,"older","0","0"
"1452",20,"189",7,"Antisocial","meat",6,8,6,7,7,-2,0,-2,1,1,"older","0","0"
"1453",20,"189",8,"Antisocial","chargers",4,6,6,7,4,0,-3,-2,1,1,"older","0","0"
"1454",20,"189",9,"Prosocial","lendMoney",8,6,6,1,2,0,1,2,1,1,"older","0","1"
"1455",21,"190",2,"Antisocial","alcoholWork",4,6,4,6,4,-2,-2,-2,4,1,"older","0","0"
"1456",21,"190",3,"Prosocial","sustainable",10,8,8,6,4,0,-2,2,4,1,"older","0","1"
"1457",21,"190",4,"Prosocial","organicVegetables",8,6,7,5,2,1,-3,2,4,1,"older","0","1"
"1458",21,"190",6,"Antisocial","lights",4,6,1,6,1,-5,-5,-2,4,1,"older","0","0"
"1459",21,"190",7,"Prosocial","vegetarian",11,9,6,6,6,-3,0,2,4,1,"older","0","1"
"1460",21,"190",8,"Antisocial","distance",4,6,6,6,5,0,-1,-2,4,1,"older","0","0"
"1461",21,"190",10,"Antisocial","shower",4,6,7,6,1,1,-5,-2,4,1,"older","0","0"
"1462",21,"190",12,"Prosocial","speed",10,8,11,4,5,3,1,2,4,1,"older","0","1"
"1463",22,"191",1,"Antisocial","shower",2,4,1,2,6,-3,4,-2,4,2,"older","0","0"
"1464",22,"191",2,"Prosocial","speed",8,6,6,2,1,0,-1,2,4,2,"older","0","1"
"1465",22,"191",3,"Prosocial","lendMoney",9,7,6,6,4,-1,-2,2,4,2,"older","0","1"
"1466",22,"191",6,"Antisocial","download",3,6,6,4,4,0,0,-3,4,2,"older","0","0"
"1467",22,"191",7,"Antisocial","chargers",4,6,6,6,6,0,0,-2,4,2,"older","0","0"
"1468",22,"191",8,"Prosocial","screentime",8,6,6,4,7,0,3,2,4,2,"older","0","1"
"1469",22,"191",9,"Prosocial","organicVegetables",8,6,3,1,1,-3,0,2,4,2,"older","0","1"
"1470",22,"191",10,"Antisocial","distance",9,11,11,7,7,0,0,-2,4,2,"older","0","0"
"1471",23,"192",1,"Antisocial","heating",3,5,6,4,5,1,1,-2,2,2,"older","0","0"
"1472",23,"192",2,"Prosocial","queue",11,9,10,3,5,1,2,2,2,2,"older","0","1"
"1473",23,"192",3,"Prosocial","lendMoney",3,1,3,1,1,2,0,2,2,2,"older","0","1"
"1474",23,"192",6,"Prosocial","crossroad",9,7,7,1,3,0,2,2,2,2,"older","0","1"
"1475",23,"192",7,"Prosocial","organicVegetables",8,6,6,1,2,0,1,2,2,2,"older","0","1"
"1476",23,"192",8,"Antisocial","meat",9,11,9,7,7,-2,0,-2,2,2,"older","0","0"
"1477",23,"192",10,"Antisocial","distance",2,4,2,6,2,-2,-4,-2,2,2,"older","0","0"
"1478",23,"192",11,"Antisocial","chargers",4,6,6,7,7,0,0,-2,2,2,"older","0","0"
"1479",24,"193",2,"Prosocial","charity",11,9,10,5,6,1,1,2,6,1,"older","0","1"
"1480",24,"193",3,"Prosocial","vegetarian",10,8,8,2,5,0,3,2,6,1,"older","0","1"
"1481",24,"193",4,"Antisocial","download",5,7,7,2,6,0,4,-2,6,1,"older","0","0"
"1482",24,"193",7,"Antisocial","lights",5,7,7,5,5,0,0,-2,6,1,"older","0","0"
"1483",24,"193",8,"Antisocial","distance",2,4,5,5,3,1,-2,-2,6,1,"older","0","0"
"1484",24,"193",9,"Antisocial","meat",6,8,6,7,6,-2,-1,-2,6,1,"older","0","0"
"1485",24,"193",11,"Prosocial","screentime",9,7,7,1,3,0,2,2,6,1,"older","0","1"
"1486",24,"193",12,"Prosocial","speed",11,9,8,3,6,-1,3,2,6,1,"older","0","1"
"1487",25,"194",1,"Antisocial","lights",1,3,3,3,3,0,0,-2,2,1,"older","0","0"
"1488",25,"194",2,"Antisocial","heating",3,5,3,2,3,-2,1,-2,2,1,"older","0","0"
"1489",25,"194",4,"Antisocial","shower",4,6,5,4,4,-1,0,-2,2,1,"older","0","0"
"1490",25,"194",5,"Prosocial","screentime",8,6,6,4,2,0,-2,2,2,1,"older","0","1"
"1491",25,"194",6,"Antisocial","distance",9,11,11,7,7,0,0,-2,2,1,"older","0","0"
"1492",25,"194",7,"Prosocial","homeless",10,8,7,5,4,-1,-1,2,2,1,"older","0","1"
"1493",25,"194",9,"Prosocial","organicVegetables",10,8,9,6,6,1,0,2,2,1,"older","0","1"
"1494",25,"194",10,"Prosocial","vegetarian",11,9,9,5,6,0,1,2,2,1,"older","0","1"
"1495",26,"195",1,"Antisocial","shower",1,2,10,1,4,8,3,-1,7,2,"older","0","0"
"1496",26,"195",2,"Prosocial","queue",8,6,10,4,1,4,-3,2,7,2,"older","0","1"
"1497",26,"195",8,"Prosocial","lendMoney",3,1,10,1,2,9,1,2,7,2,"older","0","1"
"1498",26,"195",9,"Prosocial","speed",8,6,10,4,5,4,1,2,7,2,"older","0","1"
"1499",26,"195",10,"Antisocial","distance",9,11,10,7,7,-1,0,-2,7,2,"older","0","0"
"1500",26,"195",12,"Antisocial","meat",8,10,11,7,7,1,0,-2,7,2,"older","0","0"
"1501",27,"196",1,"Prosocial","recycle",8,6,9,5,5,3,0,2,4,1,"older","0","1"
"1502",27,"196",2,"Prosocial","vegetarian",8,6,8,4,5,2,1,2,4,1,"older","0","1"
"1503",27,"196",5,"Antisocial","gathering",4,6,4,2,4,-2,2,-2,4,1,"older","0","0"
"1504",27,"196",7,"Prosocial","vaccination",8,6,8,4,4,2,0,2,4,1,"older","0","1"
"1505",27,"196",8,"Antisocial","shower",4,6,4,2,3,-2,1,-2,4,1,"older","0","0"
"1506",27,"196",10,"Prosocial","facemask",8,6,7,1,4,1,3,2,4,1,"older","0","1"
"1507",27,"196",11,"Antisocial","distance",4,6,4,2,4,-2,2,-2,4,1,"older","0","0"
"1508",27,"196",12,"Antisocial","lights",4,6,6,4,4,0,0,-2,4,1,"older","0","0"
"1509",28,"197",1,"Prosocial","lendMoney",9,7,8,5,6,1,1,2,5,2,"older","0","1"
"1510",28,"197",2,"Antisocial","redlights",1,3,3,2,2,0,0,-2,5,2,"older","0","0"
"1511",28,"197",4,"Prosocial","crossroad",11,9,9,6,6,0,0,2,5,2,"older","0","1"
"1512",28,"197",5,"Prosocial","organicVegetables",10,8,7,6,5,-1,-1,2,5,2,"older","0","1"
"1513",28,"197",6,"Antisocial","shower",2,4,4,3,4,0,1,-2,5,2,"older","0","0"
"1514",28,"197",9,"Antisocial","coughelbow",2,4,3,2,2,-1,0,-2,5,2,"older","0","0"
"1515",28,"197",11,"Antisocial","late",1,3,2,2,3,-1,1,-2,5,2,"older","0","0"
"1516",28,"197",12,"Prosocial","homeless",11,9,8,5,5,-1,0,2,5,2,"older","0","1"
"1517",29,"198",1,"Prosocial","homeless",8,6,7,4,2,1,-2,2,4,1,"older","0","1"
"1518",29,"198",3,"Prosocial","lendMoney",9,7,3,3,1,-4,-2,2,4,1,"older","0","1"
"1519",29,"198",4,"Prosocial","vegetarian",10,8,11,5,5,3,0,2,4,1,"older","0","1"
"1520",29,"198",5,"Antisocial","noisedisturbance",1,3,1,2,1,-2,-1,-2,4,1,"older","0","0"
"1521",29,"198",6,"Antisocial","shower",3,5,6,5,6,1,1,-2,4,1,"older","0","0"
"1522",29,"198",7,"Antisocial","meat",7,9,8,7,7,-1,0,-2,4,1,"older","0","0"
"1523",29,"198",10,"Prosocial","speed",8,6,8,2,5,2,3,2,4,1,"older","0","1"
"1524",29,"198",12,"Antisocial","late",2,4,2,4,5,-2,1,-2,4,1,"older","0","0"
"1525",30,"199",1,"Prosocial","crossroad",10,8,10,4,6,2,2,2,4,1,"older","0","1"
"1526",30,"199",2,"Prosocial","vegetarian",10,8,10,4,6,2,2,2,4,1,"older","0","1"
"1527",30,"199",3,"Antisocial","lights",3,5,2,4,2,-3,-2,-2,4,1,"older","0","0"
"1528",30,"199",5,"Prosocial","organicVegetables",9,7,8,4,5,1,1,2,4,1,"older","0","1"
"1529",30,"199",6,"Antisocial","coughelbow",2,4,2,2,2,-2,0,-2,4,1,"older","0","0"
"1530",30,"199",8,"Prosocial","sustainable",10,8,9,4,6,1,2,2,4,1,"older","0","1"
"1531",30,"199",10,"Antisocial","parking",2,4,2,5,2,-2,-3,-2,4,1,"older","0","0"
"1532",30,"199",12,"Antisocial","shower",3,5,3,5,2,-2,-3,-2,4,1,"older","0","0"
"1533",31,"200",1,"Antisocial","coughelbow",1,3,2,2,2,-1,0,-2,3,1,"older","0","0"
"1534",31,"200",3,"Prosocial","lendMoney",9,7,7,2,2,0,0,2,3,1,"older","0","1"
"1535",31,"200",6,"Antisocial","meat",6,8,7,6,5,-1,-1,-2,3,1,"older","0","0"
"1536",31,"200",7,"Antisocial","heating",1,2,2,2,1,0,-1,-1,3,1,"older","0","0"
"1537",31,"200",8,"Prosocial","crossroad",11,9,11,5,6,2,1,2,3,1,"older","0","1"
"1538",31,"200",9,"Prosocial","sustainable",11,9,11,5,5,2,0,2,3,1,"older","0","1"
"1539",31,"200",10,"Prosocial","vegetarian",10,8,10,6,6,2,0,2,3,1,"older","0","1"
"1540",31,"200",11,"Antisocial","shower",4,6,5,3,4,-1,1,-2,3,1,"older","0","0"
"1541",32,"201",1,"Prosocial","homeless",6,4,4,3,5,0,2,2,1,1,"older","0","1"
"1542",32,"201",2,"Antisocial","chargers",4,6,5,6,3,-1,-3,-2,1,1,"older","0","0"
"1543",32,"201",3,"Prosocial","lendMoney",6,4,5,1,5,1,4,2,1,1,"older","0","1"
"1544",32,"201",4,"Antisocial","noisedisturbance",3,5,5,2,3,0,1,-2,1,1,"older","0","0"
"1545",32,"201",6,"Antisocial","distance",9,11,10,7,6,-1,-1,-2,1,1,"older","0","0"
"1546",32,"201",8,"Antisocial","coughelbow",6,8,6,6,7,-2,1,-2,1,1,"older","0","0"
"1547",32,"201",9,"Prosocial","screentime",8,6,9,1,6,3,5,2,1,1,"older","0","1"
"1548",32,"201",11,"Prosocial","crossroad",9,7,9,4,6,2,2,2,1,1,"older","0","1"
"1549",33,"202",1,"Antisocial","shower",4,6,3,2,1,-3,-1,-2,5,1,"older","0","0"
"1550",33,"202",2,"Antisocial","meat",9,11,6,7,7,-5,0,-2,5,1,"older","0","0"
"1551",33,"202",4,"Prosocial","homeless",8,6,3,1,1,-3,0,2,5,1,"older","0","1"
"1552",33,"202",6,"Antisocial","gathering",7,10,6,4,1,-4,-3,-3,5,1,"older","0","0"
"1553",33,"202",8,"Prosocial","washands",8,6,2,2,4,-4,2,2,5,1,"older","0","1"
"1554",33,"202",9,"Antisocial","chargers",9,11,6,6,4,-5,-2,-2,5,1,"older","0","0"
"1555",33,"202",11,"Prosocial","screentime",8,6,3,2,1,-3,-1,2,5,1,"older","0","1"
"1556",33,"202",12,"Prosocial","lendMoney",3,1,1,1,1,0,0,2,5,1,"older","0","1"
"1557",34,"203",1,"Antisocial","chargers",4,6,6,7,5,0,-2,-2,3,2,"older","0","0"
"1558",34,"203",2,"Antisocial","lights",4,6,6,6,2,0,-4,-2,3,2,"older","0","0"
"1559",34,"203",3,"Prosocial","lendMoney",9,7,8,4,5,1,1,2,3,2,"older","0","1"
"1560",34,"203",4,"Antisocial","late",1,3,1,5,1,-2,-4,-2,3,2,"older","0","0"
"1561",34,"203",5,"Prosocial","queue",11,9,9,4,5,0,1,2,3,2,"older","0","1"
"1562",34,"203",6,"Prosocial","screentime",11,9,10,1,7,1,6,2,3,2,"older","0","1"
"1563",34,"203",9,"Prosocial","speed",11,9,10,5,7,1,2,2,3,2,"older","0","1"
"1564",34,"203",12,"Antisocial","distance",2,4,1,5,2,-3,-3,-2,3,2,"older","0","0"
"1565",35,"204",2,"Antisocial","lights",2,4,3,5,6,-1,1,-2,3,1,"older","0","0"
"1566",35,"204",4,"Prosocial","homeless",11,9,9,3,3,0,0,2,3,1,"older","0","1"
"1567",35,"204",5,"Prosocial","washands",8,6,6,1,5,0,4,2,3,1,"older","0","1"
"1568",35,"204",6,"Prosocial","queue",11,9,10,5,7,1,2,2,3,1,"older","0","1"
"1569",35,"204",7,"Antisocial","coughelbow",4,6,5,4,1,-1,-3,-2,3,1,"older","0","0"
"1570",35,"204",10,"Prosocial","recycle",8,6,6,4,3,0,-1,2,3,1,"older","0","1"
"1571",35,"204",11,"Antisocial","chargers",4,6,6,7,7,0,0,-2,3,1,"older","0","0"
"1572",35,"204",12,"Antisocial","shower",4,6,6,7,7,0,0,-2,3,1,"older","0","0"
"1573",36,"205",2,"Antisocial","coughelbow",3,5,2,2,1,-3,-1,-2,4,2,"older","0","0"
"1574",36,"205",4,"Prosocial","sustainable",11,9,6,4,5,-3,1,2,4,2,"older","0","1"
"1575",36,"205",5,"Prosocial","homeless",11,9,6,2,4,-3,2,2,4,2,"older","0","1"
"1576",36,"205",6,"Antisocial","meat",6,8,7,7,6,-1,-1,-2,4,2,"older","0","0"
"1577",36,"205",8,"Antisocial","chargers",6,8,6,7,4,-2,-3,-2,4,2,"older","0","0"
"1578",36,"205",9,"Antisocial","shower",4,6,6,6,4,0,-2,-2,4,2,"older","0","0"
"1579",36,"205",10,"Prosocial","washands",11,9,11,6,7,2,1,2,4,2,"older","0","1"
"1580",36,"205",12,"Prosocial","organicVegetables",8,6,6,3,1,0,-2,2,4,2,"older","0","1"
"1581",37,"206",1,"Antisocial","distance",4,6,2,7,4,-4,-3,-2,4,1,"older","0","0"
"1582",37,"206",2,"Prosocial","washands",10,8,8,5,4,0,-1,2,4,1,"older","0","1"
"1583",37,"206",3,"Prosocial","vegetarian",11,9,6,6,5,-3,-1,2,4,1,"older","0","1"
"1584",37,"206",4,"Antisocial","gathering",4,6,8,5,5,2,0,-2,4,1,"older","0","0"
"1585",37,"206",5,"Prosocial","queue",6,4,8,6,6,4,0,2,4,1,"older","0","1"
"1586",37,"206",6,"Antisocial","chargers",4,6,8,7,7,2,0,-2,4,1,"older","0","0"
"1587",37,"206",7,"Antisocial","shower",4,6,6,2,5,0,3,-2,4,1,"older","0","0"
"1588",37,"206",11,"Prosocial","bike",11,9,10,1,1,1,0,2,4,1,"older","0","1"
"1589",38,"207",1,"Antisocial","late",2,4,3,2,2,-1,0,-2,6,1,"older","0","0"
"1590",38,"207",2,"Antisocial","shower",1,3,4,2,2,1,0,-2,6,1,"older","0","0"
"1591",38,"207",3,"Prosocial","queue",8,6,7,2,2,1,0,2,6,1,"older","0","1"
"1592",38,"207",5,"Antisocial","garbage",3,5,3,3,2,-2,-1,-2,6,1,"older","0","0"
"1593",38,"207",6,"Prosocial","screentime",10,8,7,2,2,-1,0,2,6,1,"older","0","1"
"1594",38,"207",9,"Antisocial","distance",3,5,3,6,1,-2,-5,-2,6,1,"older","0","0"
"1595",38,"207",10,"Prosocial","charity",10,8,11,4,7,3,3,2,6,1,"older","0","1"
"1596",38,"207",12,"Prosocial","homeless",8,6,8,2,2,2,0,2,6,1,"older","0","1"
"1597",39,"208",1,"Prosocial","lendMoney",3,1,6,3,2,5,-1,2,3,2,"older","0","1"
"1598",39,"208",2,"Antisocial","lights",4,6,10,5,4,4,-1,-2,3,2,"older","0","0"
"1599",39,"208",6,"Antisocial","redlights",3,5,3,5,3,-2,-2,-2,3,2,"older","0","0"
"1600",39,"208",8,"Antisocial","gathering",5,7,5,5,4,-2,-1,-2,3,2,"older","0","0"
"1601",39,"208",9,"Prosocial","bike",7,5,11,1,1,6,0,2,3,2,"older","0","1"
"1602",39,"208",10,"Antisocial","chargers",9,11,9,7,7,-2,0,-2,3,2,"older","0","0"
"1603",39,"208",11,"Prosocial","vegetarian",10,8,11,4,4,3,0,2,3,2,"older","0","1"
"1604",39,"208",12,"Prosocial","volunteer",10,8,11,5,7,3,2,2,3,2,"older","0","1"
"1605",40,"209",2,"Prosocial","washands",11,9,11,5,7,2,2,2,3,2,"older","0","1"
"1606",40,"209",4,"Antisocial","distance",4,6,2,3,4,-4,1,-2,3,2,"older","0","0"
"1607",40,"209",5,"Antisocial","meat",8,10,10,7,7,0,0,-2,3,2,"older","0","0"
"1608",40,"209",6,"Prosocial","vegetarian",10,8,11,5,5,3,0,2,3,2,"older","0","1"
"1609",40,"209",7,"Prosocial","sustainable",11,9,8,4,4,-1,0,2,3,2,"older","0","1"
"1610",40,"209",8,"Antisocial","shower",4,6,6,7,6,0,-1,-2,3,2,"older","0","0"
"1611",40,"209",9,"Prosocial","volunteer",11,9,11,1,4,2,3,2,3,2,"older","0","1"
"1612",40,"209",10,"Antisocial","lights",2,4,1,3,1,-3,-2,-2,3,2,"older","0","0"
"1613",41,"210",2,"Prosocial","vaccination",8,6,1,1,1,-5,0,2,2,1,"older","0","1"
"1614",41,"210",3,"Antisocial","download",3,6,10,6,7,4,1,-3,2,1,"older","0","0"
"1615",41,"210",4,"Prosocial","facemask",8,6,4,1,1,-2,0,2,2,1,"older","0","1"
"1616",41,"210",5,"Antisocial","distance",4,6,9,7,6,3,-1,-2,2,1,"older","0","0"
"1617",41,"210",6,"Antisocial","chargers",4,6,6,7,7,0,0,-2,2,1,"older","0","0"
"1618",41,"210",9,"Prosocial","screentime",10,8,1,6,1,-7,-5,2,2,1,"older","0","1"
"1619",41,"210",10,"Antisocial","gathering",4,6,9,7,7,3,0,-2,2,1,"older","0","0"
"1620",41,"210",11,"Prosocial","queue",8,6,7,5,5,1,0,2,2,1,"older","0","1"
"1621",42,"211",1,"Antisocial","alcoholWork",4,6,7,7,5,1,-2,-2,7,1,"older","0","0"
"1622",42,"211",2,"Antisocial","late",2,4,6,2,1,2,-1,-2,7,1,"older","0","0"
"1623",42,"211",4,"Antisocial","coughelbow",2,4,5,4,1,1,-3,-2,7,1,"older","0","0"
"1624",42,"211",5,"Prosocial","crossroad",10,8,4,2,2,-4,0,2,7,1,"older","0","1"
"1625",42,"211",6,"Prosocial","screentime",8,6,4,2,5,-2,3,2,7,1,"older","0","1"
"1626",42,"211",8,"Antisocial","distance",1,3,6,5,3,3,-2,-2,7,1,"older","0","0"
"1627",42,"211",9,"Prosocial","seatBus",10,8,6,2,2,-2,0,2,7,1,"older","0","1"
"1628",42,"211",11,"Prosocial","homeless",8,6,6,1,1,0,0,2,7,1,"older","0","1"
"1629",43,"212",1,"Prosocial","volunteer",10,8,10,5,7,2,2,2,5,1,"older","0","1"
"1630",43,"212",2,"Antisocial","shower",4,6,4,6,4,-2,-2,-2,5,1,"older","0","0"
"1631",43,"212",4,"Antisocial","chargers",4,6,6,7,6,0,-1,-2,5,1,"older","0","0"
"1632",43,"212",6,"Antisocial","heating",4,6,5,4,1,-1,-3,-2,5,1,"older","0","0"
"1633",43,"212",7,"Prosocial","speed",11,9,11,6,6,2,0,2,5,1,"older","0","1"
"1634",43,"212",9,"Prosocial","bike",9,7,10,1,1,3,0,2,5,1,"older","0","1"
"1635",43,"212",10,"Antisocial","distance",9,11,11,6,7,0,1,-2,5,1,"older","0","0"
"1636",43,"212",12,"Prosocial","screentime",7,5,6,1,3,1,2,2,5,1,"older","0","1"
"1637",44,"213",1,"Prosocial","bike",6,1,11,1,1,10,0,5,1,1,"older","0","1"
"1638",44,"213",4,"Prosocial","screentime",5,1,11,1,1,10,0,4,1,1,"older","0","1"
"1639",44,"213",5,"Antisocial","late",6,11,8,7,5,-3,-2,-5,1,1,"older","0","0"
"1640",44,"213",6,"Prosocial","volunteer",8,6,4,1,1,-2,0,2,1,1,"older","0","1"
"1641",44,"213",11,"Antisocial","meat",8,10,7,7,3,-3,-4,-2,1,1,"older","0","0"
"1642",44,"213",12,"Prosocial","lendMoney",3,1,1,1,1,0,0,2,1,1,"older","0","1"
"1643",45,"214",1,"Prosocial","sustainable",9,7,6,5,4,-1,-1,2,4,1,"older","0","1"
"1644",45,"214",2,"Prosocial","volunteer",8,6,8,5,5,2,0,2,4,1,"older","0","1"
"1645",45,"214",5,"Antisocial","late",1,3,1,3,2,-2,-1,-2,4,1,"older","0","0"
"1646",45,"214",6,"Prosocial","seatBus",7,5,6,4,3,1,-1,2,4,1,"older","0","1"
"1647",45,"214",7,"Prosocial","queue",8,6,6,4,2,0,-2,2,4,1,"older","0","1"
"1648",45,"214",8,"Antisocial","shower",1,3,1,3,1,-2,-2,-2,4,1,"older","0","0"
"1649",45,"214",9,"Antisocial","alcoholWork",1,3,1,4,2,-2,-2,-2,4,1,"older","0","0"
"1650",45,"214",12,"Antisocial","meat",7,9,6,5,7,-3,2,-2,4,1,"older","0","0"
"1651",46,"215",1,"Antisocial","lights",4,6,6,5,5,0,0,-2,3,1,"older","0","0"
"1652",46,"215",2,"Prosocial","queue",8,6,8,4,6,2,2,2,3,1,"older","0","1"
"1653",46,"215",3,"Antisocial","gathering",3,5,2,3,2,-3,-1,-2,3,1,"older","0","0"
"1654",46,"215",4,"Prosocial","speed",10,8,10,3,6,2,3,2,3,1,"older","0","1"
"1655",46,"215",6,"Prosocial","lendMoney",9,7,6,4,4,-1,0,2,3,1,"older","0","1"
"1656",46,"215",9,"Antisocial","distance",3,5,2,5,2,-3,-3,-2,3,1,"older","0","0"
"1657",46,"215",10,"Prosocial","homeless",10,8,7,6,5,-1,-1,2,3,1,"older","0","1"
"1658",46,"215",12,"Antisocial","shower",5,7,6,5,4,-1,-1,-2,3,1,"older","0","0"
"1659",47,"216",1,"Antisocial","noisedisturbance",4,6,4,4,3,-2,-1,-2,3,2,"older","0","0"
"1660",47,"216",6,"Antisocial","distance",9,11,11,7,7,0,0,-2,3,2,"older","0","0"
"1661",47,"216",7,"Prosocial","queue",9,7,9,1,6,2,5,2,3,2,"older","0","1"
"1662",47,"216",8,"Antisocial","heating",4,6,2,4,2,-4,-2,-2,3,2,"older","0","0"
"1663",47,"216",9,"Prosocial","vaccination",7,5,3,1,2,-2,1,2,3,2,"older","0","1"
"1664",47,"216",10,"Antisocial","meat",9,11,9,6,6,-2,0,-2,3,2,"older","0","0"
"1665",47,"216",11,"Prosocial","vegetarian",11,9,11,1,6,2,5,2,3,2,"older","0","1"
"1666",48,"217",1,"Prosocial","bike",8,6,10,1,1,4,0,2,3,1,"older","0","1"
"1667",48,"217",2,"Antisocial","lights",4,6,4,6,4,-2,-2,-2,3,1,"older","0","0"
"1668",48,"217",3,"Antisocial","shower",4,6,6,3,2,0,-1,-2,3,1,"older","0","0"
"1669",48,"217",8,"Prosocial","sustainable",8,6,7,3,4,1,1,2,3,1,"older","0","1"
"1670",48,"217",9,"Antisocial","chargers",4,6,6,7,7,0,0,-2,3,1,"older","0","0"
"1671",48,"217",10,"Antisocial","meat",9,11,11,7,7,0,0,-2,3,1,"older","0","0"
"1672",48,"217",11,"Prosocial","ownbag",8,6,6,1,1,0,0,2,3,1,"older","0","1"
"1673",48,"217",12,"Prosocial","lendMoney",11,9,11,2,4,2,2,2,3,1,"older","0","1"
"1674",49,"218",2,"Antisocial","meat",8,10,9,7,6,-1,-1,-2,2,2,"older","0","0"
"1675",49,"218",3,"Prosocial","homeless",8,6,6,5,4,0,-1,2,2,2,"older","0","1"
"1676",49,"218",5,"Prosocial","queue",8,6,8,5,4,2,-1,2,2,2,"older","0","1"
"1677",49,"218",6,"Prosocial","screentime",8,6,8,5,6,2,1,2,2,2,"older","0","1"
"1678",49,"218",8,"Antisocial","shower",4,6,6,6,4,0,-2,-2,2,2,"older","0","0"
"1679",49,"218",10,"Antisocial","distance",6,9,5,4,3,-4,-1,-3,2,2,"older","0","0"
"1680",49,"218",11,"Prosocial","vegetarian",8,6,6,1,3,0,2,2,2,2,"older","0","1"
"1681",49,"218",12,"Antisocial","chargers",4,6,7,7,5,1,-2,-2,2,2,"older","0","0"
"1682",50,"219",1,"Antisocial","shower",3,5,4,3,2,-1,-1,-2,6,1,"older","0","0"
"1683",50,"219",4,"Prosocial","vegetarian",10,8,9,6,5,1,-1,2,6,1,"older","0","1"
"1684",50,"219",5,"Antisocial","alcoholWork",3,5,3,2,2,-2,0,-2,6,1,"older","0","0"
"1685",50,"219",6,"Antisocial","distance",4,6,5,3,3,-1,0,-2,6,1,"older","0","0"
"1686",50,"219",9,"Prosocial","speed",8,6,7,5,5,1,0,2,6,1,"older","0","1"
"1687",50,"219",10,"Antisocial","lights",4,6,4,5,7,-2,2,-2,6,1,"older","0","0"
"1688",50,"219",11,"Prosocial","volunteer",11,9,11,3,1,2,-2,2,6,1,"older","0","1"
"1689",50,"219",12,"Prosocial","queue",11,9,10,3,2,1,-1,2,6,1,"older","0","1"
"1690",51,"220",1,"Antisocial","lights",3,5,5,4,2,0,-2,-2,4,2,"older","0","0"
"1691",51,"220",2,"Prosocial","sustainable",9,7,7,1,5,0,4,2,4,2,"older","0","1"
"1692",51,"220",3,"Prosocial","lendMoney",9,7,7,1,5,0,4,2,4,2,"older","0","1"
"1693",51,"220",6,"Antisocial","shower",3,5,5,5,5,0,0,-2,4,2,"older","0","0"
"1694",51,"220",7,"Prosocial","ownbag",10,8,8,1,5,0,4,2,4,2,"older","0","1"
"1695",51,"220",9,"Antisocial","late",3,5,5,5,5,0,0,-2,4,2,"older","0","0"
"1696",51,"220",10,"Antisocial","gathering",3,5,5,4,5,0,1,-2,4,2,"older","0","0"
"1697",51,"220",11,"Prosocial","speed",9,7,6,5,3,-1,-2,2,4,2,"older","0","1"
"1698",52,"221",1,"Antisocial","chargers",5,7,5,6,4,-2,-2,-2,6,2,"older","0","0"
"1699",52,"221",3,"Antisocial","shower",1,3,1,1,1,-2,0,-2,6,2,"older","0","0"
"1700",52,"221",5,"Antisocial","meat",9,11,10,7,7,-1,0,-2,6,2,"older","0","0"
"1701",52,"221",7,"Prosocial","lendMoney",8,6,7,2,3,1,1,2,6,2,"older","0","1"
"1702",52,"221",8,"Prosocial","speed",9,7,10,6,6,3,0,2,6,2,"older","0","1"
"1703",52,"221",9,"Prosocial","queue",9,7,10,5,5,3,0,2,6,2,"older","0","1"
"1704",52,"221",11,"Antisocial","gathering",5,7,6,4,4,-1,0,-2,6,2,"older","0","0"
"1705",52,"221",12,"Prosocial","vegetarian",8,6,8,4,3,2,-1,2,6,2,"older","0","1"
"1706",53,"222",1,"Prosocial","homeless",10,8,9,6,6,1,0,2,3,2,"older","0","1"
"1707",53,"222",2,"Antisocial","coughelbow",4,6,8,4,6,2,2,-2,3,2,"older","0","0"
"1708",53,"222",3,"Prosocial","speed",11,9,8,4,5,-1,1,2,3,2,"older","0","1"
"1709",53,"222",4,"Antisocial","taxes",4,6,4,3,3,-2,0,-2,3,2,"older","0","0"
"1710",53,"222",5,"Antisocial","distance",8,10,5,2,4,-5,2,-2,3,2,"older","0","0"
"1711",53,"222",7,"Antisocial","gathering",4,6,6,6,4,0,-2,-2,3,2,"older","0","0"
"1712",53,"222",8,"Prosocial","screentime",8,6,6,6,4,0,-2,2,3,2,"older","0","1"
"1713",53,"222",10,"Prosocial","facemask",6,4,7,4,4,3,0,2,3,2,"older","0","1"
"1714",54,"223",1,"Prosocial","vegetarian",11,9,10,6,5,1,-1,2,6,1,"older","0","1"
"1715",54,"223",3,"Prosocial","organicVegetables",11,9,8,4,5,-1,1,2,6,1,"older","0","1"
"1716",54,"223",6,"Prosocial","screentime",8,6,6,3,4,0,1,2,6,1,"older","0","1"
"1717",54,"223",7,"Antisocial","meat",6,8,6,7,6,-2,-1,-2,6,1,"older","0","0"
"1718",54,"223",8,"Antisocial","chargers",4,6,6,6,6,0,0,-2,6,1,"older","0","0"
"1719",54,"223",9,"Antisocial","distance",9,11,11,7,7,0,0,-2,6,1,"older","0","0"
"1720",54,"223",12,"Prosocial","lendMoney",8,6,6,1,4,0,3,2,6,1,"older","0","1"
"1721",55,"224",2,"Antisocial","chargers",4,6,7,7,7,1,0,-2,3,1,"older","0","0"
"1722",55,"224",3,"Antisocial","late",1,3,1,5,1,-2,-4,-2,3,1,"older","0","0"
"1723",55,"224",4,"Prosocial","queue",11,9,8,5,5,-1,0,2,3,1,"older","0","1"
"1724",55,"224",6,"Antisocial","meat",9,11,11,7,7,0,0,-2,3,1,"older","0","0"
"1725",55,"224",7,"Prosocial","washands",8,6,11,2,7,5,5,2,3,1,"older","0","1"
"1726",55,"224",9,"Antisocial","coughelbow",2,4,3,6,1,-1,-5,-2,3,1,"older","0","0"
"1727",55,"224",10,"Prosocial","speed",10,8,9,2,6,1,4,2,3,1,"older","0","1"
"1728",55,"224",12,"Prosocial","lendMoney",5,3,3,1,1,0,0,2,3,1,"older","0","1"
"1729",56,"225",2,"Prosocial","speed",11,9,8,6,4,-1,-2,2,6,1,"older","0","1"
"1730",56,"225",3,"Prosocial","vegetarian",9,7,4,6,3,-3,-3,2,6,1,"older","0","1"
"1731",56,"225",4,"Prosocial","volunteer",8,6,5,1,5,-1,4,2,6,1,"older","0","1"
"1732",56,"225",5,"Antisocial","meat",8,10,7,7,5,-3,-2,-2,6,1,"older","0","0"
"1733",56,"225",7,"Antisocial","distance",6,8,7,7,5,-1,-2,-2,6,1,"older","0","0"
"1734",56,"225",9,"Prosocial","queue",7,5,9,4,4,4,0,2,6,1,"older","0","1"
"1735",57,"226",1,"Prosocial","screentime",8,6,7,4,5,1,1,2,4,1,"older","0","1"
"1736",57,"226",2,"Antisocial","late",1,2,1,1,1,-1,0,-1,4,1,"older","0","0"
"1737",57,"226",3,"Prosocial","lendMoney",3,1,1,1,1,0,0,2,4,1,"older","0","1"
"1738",57,"226",4,"Prosocial","crossroad",10,8,10,4,6,2,2,2,4,1,"older","0","1"
"1739",57,"226",8,"Antisocial","shower",4,6,6,4,1,0,-3,-2,4,1,"older","0","0"
"1740",57,"226",9,"Prosocial","seatBus",11,9,8,4,1,-1,-3,2,4,1,"older","0","1"
"1741",57,"226",11,"Antisocial","chargers",4,6,6,7,7,0,0,-2,4,1,"older","0","0"
"1742",58,"227",3,"Prosocial","homeless",10,8,6,2,2,-2,0,2,4,1,"older","0","1"
"1743",58,"227",6,"Antisocial","meat",7,9,9,7,7,0,0,-2,4,1,"older","0","0"
"1744",58,"227",7,"Prosocial","screentime",8,6,6,1,2,0,1,2,4,1,"older","0","1"
"1745",58,"227",8,"Antisocial","shower",2,4,6,3,4,2,1,-2,4,1,"older","0","0"
"1746",58,"227",9,"Antisocial","download",8,10,10,2,5,0,3,-2,4,1,"older","0","0"
"1747",58,"227",10,"Antisocial","chargers",4,6,6,5,6,0,1,-2,4,1,"older","0","0"
"1748",58,"227",11,"Prosocial","charity",10,8,11,5,6,3,1,2,4,1,"older","0","1"
"1749",58,"227",12,"Prosocial","lendMoney",8,6,6,3,4,0,1,2,4,1,"older","0","1"
"1750",59,"228",1,"Prosocial","lendMoney",8,6,6,4,3,0,-1,2,4,1,"older","0","1"
"1751",59,"228",2,"Antisocial","lights",4,6,3,2,1,-3,-1,-2,4,1,"older","0","0"
"1752",59,"228",4,"Prosocial","bike",8,6,6,1,1,0,0,2,4,1,"older","0","1"
"1753",59,"228",5,"Antisocial","noisedisturbance",2,4,2,2,1,-2,-1,-2,4,1,"older","0","0"
"1754",59,"228",8,"Antisocial","chargers",4,6,6,4,5,0,1,-2,4,1,"older","0","0"
"1755",59,"228",9,"Prosocial","speed",8,6,6,3,4,0,1,2,4,1,"older","0","1"
"1756",59,"228",11,"Prosocial","homeless",10,8,9,4,3,1,-1,2,4,1,"older","0","1"
"1757",59,"228",12,"Antisocial","meat",8,10,8,7,6,-2,-1,-2,4,1,"older","0","0"
"1758",60,"229",1,"Antisocial","gathering",3,5,4,4,2,-1,-2,-2,4,1,"older","0","0"
"1759",60,"229",3,"Prosocial","speed",10,8,6,2,2,-2,0,2,4,1,"older","0","1"
"1760",60,"229",4,"Antisocial","noisedisturbance",3,5,3,4,2,-2,-2,-2,4,1,"older","0","0"
"1761",60,"229",8,"Prosocial","screentime",8,6,6,4,6,0,2,2,4,1,"older","0","1"
"1762",60,"229",9,"Antisocial","alcoholWork",4,6,4,5,1,-2,-4,-2,4,1,"older","0","0"
"1763",60,"229",10,"Antisocial","chargers",1,3,5,5,7,2,2,-2,4,1,"older","0","0"
"1764",60,"229",11,"Prosocial","homeless",9,7,7,4,4,0,0,2,4,1,"older","0","1"
"1765",60,"229",12,"Prosocial","lendMoney",8,6,6,3,5,0,2,2,4,1,"older","0","1"
"1766",61,"230",3,"Prosocial","screentime",8,6,6,1,2,0,1,2,6,2,"older","0","1"
"1767",61,"230",5,"Antisocial","gathering",4,6,4,7,3,-2,-4,-2,6,2,"older","0","0"
"1768",61,"230",6,"Antisocial","distance",4,6,6,6,4,0,-2,-2,6,2,"older","0","0"
"1769",61,"230",7,"Antisocial","shower",1,3,3,3,3,0,0,-2,6,2,"older","0","0"
"1770",61,"230",8,"Prosocial","queue",10,8,11,5,7,3,2,2,6,2,"older","0","1"
"1771",61,"230",9,"Prosocial","homeless",9,7,8,3,5,1,2,2,6,2,"older","0","1"
"1772",61,"230",10,"Prosocial","vaccination",10,8,11,6,7,3,1,2,6,2,"older","0","1"
"1773",61,"230",12,"Antisocial","chargers",4,6,4,7,5,-2,-2,-2,6,2,"older","0","0"
"1774",62,"231",1,"Antisocial","alcoholWork",6,8,7,2,5,-1,3,-2,2,1,"older","0","0"
"1775",62,"231",2,"Prosocial","seatBus",9,7,7,3,5,0,2,2,2,1,"older","0","1"
"1776",62,"231",4,"Prosocial","ownbag",9,7,8,6,7,1,1,2,2,1,"older","0","1"
"1777",62,"231",6,"Prosocial","homeless",7,5,3,2,1,-2,-1,2,2,1,"older","0","1"
"1778",62,"231",7,"Antisocial","travelticket",3,5,2,3,1,-3,-2,-2,2,1,"older","0","0"
"1779",62,"231",9,"Prosocial","lendMoney",6,4,3,4,1,-1,-3,2,2,1,"older","0","1"
"1780",62,"231",10,"Antisocial","late",1,3,2,3,2,-1,-1,-2,2,1,"older","0","0"
"1781",62,"231",12,"Antisocial","heating",3,5,3,2,1,-2,-1,-2,2,1,"older","0","0"
"1782",63,"232",1,"Antisocial","lights",4,6,4,6,3,-2,-3,-2,3,2,"older","0","0"
"1783",63,"232",3,"Prosocial","organicVegetables",8,6,8,5,4,2,-1,2,3,2,"older","0","1"
"1784",63,"232",4,"Prosocial","vegetarian",8,6,9,1,4,3,3,2,3,2,"older","0","1"
"1785",63,"232",5,"Prosocial","speed",8,6,9,4,4,3,0,2,3,2,"older","0","1"
"1786",63,"232",7,"Antisocial","distance",2,4,2,7,2,-2,-5,-2,3,2,"older","0","0"
"1787",63,"232",9,"Prosocial","queue",8,6,6,4,4,0,0,2,3,2,"older","0","1"
"1788",63,"232",10,"Antisocial","shower",4,6,4,2,3,-2,1,-2,3,2,"older","0","0"
"1789",63,"232",11,"Antisocial","chargers",1,4,6,7,7,2,0,-3,3,2,"older","0","0"
"1790",64,"233",1,"Antisocial","lights",3,5,6,3,4,1,1,-2,3,1,"older","0","0"
"1791",64,"233",2,"Prosocial","speed",8,6,6,4,1,0,-3,2,3,1,"older","0","1"
"1792",64,"233",4,"Prosocial","homeless",11,9,7,4,5,-2,1,2,3,1,"older","0","1"
"1793",64,"233",6,"Antisocial","chargers",4,6,6,7,7,0,0,-2,3,1,"older","0","0"
"1794",64,"233",8,"Prosocial","bike",8,6,6,1,1,0,0,2,3,1,"older","0","1"
"1795",64,"233",9,"Prosocial","queue",10,8,8,4,7,0,3,2,3,1,"older","0","1"
"1796",64,"233",11,"Antisocial","heating",4,6,6,2,5,0,3,-2,3,1,"older","0","0"
"1797",64,"233",12,"Antisocial","redlights",2,4,3,4,3,-1,-1,-2,3,1,"older","0","0"
"1798",65,"234",1,"Antisocial","chargers",6,9,8,7,7,-1,0,-3,2,1,"older","0","0"
"1799",65,"234",2,"Prosocial","facemask",9,7,9,3,5,2,2,2,2,1,"older","0","1"
"1800",65,"234",5,"Antisocial","shower",1,3,6,3,2,3,-1,-2,2,1,"older","0","0"
"1801",65,"234",7,"Prosocial","organicVegetables",9,7,7,1,1,0,0,2,2,1,"older","0","1"
"1802",65,"234",8,"Antisocial","meat",9,11,11,7,7,0,0,-2,2,1,"older","0","0"
"1803",65,"234",10,"Prosocial","speed",10,8,9,3,3,1,0,2,2,1,"older","0","1"
"1804",65,"234",11,"Prosocial","homeless",9,7,5,2,2,-2,0,2,2,1,"older","0","1"
"1805",65,"234",12,"Antisocial","distance",8,10,8,4,6,-2,2,-2,2,1,"older","0","0"
"1806",66,"235",1,"Prosocial","homeless",7,5,4,2,2,-1,0,2,3,2,"older","0","1"
"1807",66,"235",2,"Antisocial","shower",4,6,3,3,5,-3,2,-2,3,2,"older","0","0"
"1808",66,"235",4,"Antisocial","gathering",4,6,6,4,6,0,2,-2,3,2,"older","0","0"
"1809",66,"235",5,"Antisocial","alcoholWork",4,6,3,2,5,-3,3,-2,3,2,"older","0","0"
"1810",66,"235",6,"Prosocial","facemask",10,8,9,2,2,1,0,2,3,2,"older","0","1"
"1811",66,"235",7,"Prosocial","sustainable",10,8,10,3,5,2,2,2,3,2,"older","0","1"
"1812",66,"235",8,"Antisocial","late",2,4,2,2,3,-2,1,-2,3,2,"older","0","0"
"1813",66,"235",12,"Prosocial","bike",9,7,10,1,3,3,2,2,3,2,"older","0","1"
"1814",67,"236",3,"Prosocial","facemask",8,6,1,1,2,-5,1,2,3,2,"older","0","1"
"1815",67,"236",5,"Prosocial","volunteer",8,6,7,1,1,1,0,2,3,2,"older","0","1"
"1816",67,"236",6,"Antisocial","garbage",2,4,2,2,3,-2,1,-2,3,2,"older","0","0"
"1817",67,"236",8,"Antisocial","chargers",4,6,6,5,3,0,-2,-2,3,2,"older","0","0"
"1818",67,"236",9,"Prosocial","lendMoney",8,6,6,1,1,0,0,2,3,2,"older","0","1"
"1819",67,"236",10,"Prosocial","speed",10,8,5,3,5,-3,2,2,3,2,"older","0","1"
"1820",67,"236",11,"Antisocial","late",1,3,6,3,5,3,2,-2,3,2,"older","0","0"
"1821",67,"236",12,"Antisocial","gathering",4,6,11,6,4,5,-2,-2,3,2,"older","0","0"
"1822",68,"237",2,"Antisocial","chargers",6,8,8,7,6,0,-1,-2,6,1,"older","0","0"
"1823",68,"237",3,"Antisocial","shower",2,4,4,2,2,0,0,-2,6,1,"older","0","0"
"1824",68,"237",4,"Prosocial","charity",11,9,11,5,7,2,2,2,6,1,"older","0","1"
"1825",68,"237",6,"Antisocial","distance",3,5,4,4,2,-1,-2,-2,6,1,"older","0","0"
"1826",68,"237",7,"Prosocial","vegetarian",10,8,9,1,6,1,5,2,6,1,"older","0","1"
"1827",68,"237",8,"Antisocial","gathering",4,6,4,3,2,-2,-1,-2,6,1,"older","0","0"
"1828",68,"237",10,"Prosocial","queue",10,8,10,3,7,2,4,2,6,1,"older","0","1"
"1829",68,"237",11,"Prosocial","vaccination",10,8,11,6,6,3,0,2,6,1,"older","0","1"
"1830",69,"238",3,"Prosocial","lendMoney",5,3,9,3,1,6,-2,2,3,1,"older","0","1"
"1831",69,"238",4,"Prosocial","facemask",8,6,6,1,1,0,0,2,3,1,"older","0","1"
"1832",69,"238",5,"Prosocial","washands",11,9,11,6,7,2,1,2,3,1,"older","0","1"
"1833",69,"238",6,"Prosocial","bike",8,6,7,1,1,1,0,2,3,1,"older","0","1"
"1834",69,"238",8,"Antisocial","lights",5,7,8,6,7,1,1,-2,3,1,"older","0","0"
"1835",69,"238",9,"Antisocial","chargers",6,8,9,7,7,1,0,-2,3,1,"older","0","0"
"1836",69,"238",11,"Antisocial","meat",9,11,11,7,7,0,0,-2,3,1,"older","0","0"
"1837",69,"238",12,"Antisocial","gathering",7,9,9,5,7,0,2,-2,3,1,"older","0","0"
"1838",70,"239",1,"Prosocial","screentime",8,6,6,2,7,0,5,2,4,1,"older","0","1"
"1839",70,"239",2,"Antisocial","lights",6,8,2,4,1,-6,-3,-2,4,1,"older","0","0"
"1840",70,"239",3,"Prosocial","recycle",11,9,10,5,4,1,-1,2,4,1,"older","0","1"
"1841",70,"239",5,"Prosocial","lendMoney",8,6,6,1,4,0,3,2,4,1,"older","0","1"
"1842",70,"239",6,"Antisocial","shower",4,6,8,2,6,2,4,-2,4,1,"older","0","0"
"1843",70,"239",7,"Antisocial","noisedisturbance",1,3,1,2,1,-2,-1,-2,4,1,"older","0","0"
"1844",70,"239",11,"Prosocial","sustainable",9,7,7,2,4,0,2,2,4,1,"older","0","1"
"1845",70,"239",12,"Antisocial","heating",4,6,6,2,4,0,2,-2,4,1,"older","0","0"
"1846",71,"240",1,"Antisocial","lights",1,3,3,2,1,0,-1,-2,5,1,"older","0","0"
"1847",71,"240",3,"Antisocial","chargers",4,6,4,6,7,-2,1,-2,5,1,"older","0","0"
"1848",71,"240",4,"Prosocial","speed",11,9,10,6,6,1,0,2,5,1,"older","0","1"
"1849",71,"240",5,"Prosocial","vegetarian",10,8,8,4,4,0,0,2,5,1,"older","0","1"
"1850",71,"240",6,"Antisocial","shower",4,6,4,3,3,-2,0,-2,5,1,"older","0","0"
"1851",71,"240",8,"Prosocial","homeless",11,9,10,3,4,1,1,2,5,1,"older","0","1"
"1852",71,"240",10,"Prosocial","screentime",9,7,6,2,4,-1,2,2,5,1,"older","0","1"
"1853",71,"240",12,"Antisocial","noisedisturbance",2,4,3,2,2,-1,0,-2,5,1,"older","0","0"
"1854",72,"241",2,"Prosocial","homeless",10,8,5,5,4,-3,-1,2,2,1,"older","0","1"
"1855",72,"241",3,"Prosocial","seatBus",11,9,1,5,1,-8,-4,2,2,1,"older","0","1"
"1856",72,"241",4,"Antisocial","redlights",3,5,3,2,3,-2,1,-2,2,1,"older","0","0"
"1857",72,"241",6,"Prosocial","speed",10,8,9,5,7,1,2,2,2,1,"older","0","1"
"1858",72,"241",7,"Antisocial","distance",4,6,5,3,5,-1,2,-2,2,1,"older","0","0"
"1859",72,"241",8,"Antisocial","late",2,4,4,3,4,0,1,-2,2,1,"older","0","0"
"1860",72,"241",9,"Antisocial","meat",9,11,11,7,7,0,0,-2,2,1,"older","0","0"
"1861",72,"241",10,"Prosocial","queue",8,6,3,4,1,-3,-3,2,2,1,"older","0","1"
"1862",73,"242",2,"Antisocial","meat",6,8,8,7,6,0,-1,-2,1,2,"older","0","0"
"1863",73,"242",4,"Prosocial","volunteer",11,9,11,2,7,2,5,2,1,2,"older","0","1"
"1864",73,"242",6,"Antisocial","chargers",4,6,6,7,6,0,-1,-2,1,2,"older","0","0"
"1865",73,"242",7,"Prosocial","queue",10,8,11,6,6,3,0,2,1,2,"older","0","1"
"1866",73,"242",8,"Prosocial","screentime",8,6,10,4,6,4,2,2,1,2,"older","0","1"
"1867",73,"242",9,"Prosocial","lendMoney",8,6,6,3,1,0,-2,2,1,2,"older","0","1"
"1868",73,"242",10,"Antisocial","distance",9,11,11,2,7,0,5,-2,1,2,"older","0","0"
"1869",73,"242",12,"Antisocial","late",2,4,1,4,1,-3,-3,-2,1,2,"older","0","0"
"1870",74,"243",3,"Antisocial","gathering",1,2,2,1,1,0,0,-1,4,1,"older","0","0"
"1871",74,"243",6,"Antisocial","noisedisturbance",1,3,4,2,5,1,3,-2,4,1,"older","0","0"
"1872",74,"243",7,"Antisocial","lights",2,4,2,5,5,-2,0,-2,4,1,"older","0","0"
"1873",74,"243",8,"Prosocial","queue",10,8,10,5,6,2,1,2,4,1,"older","0","1"
"1874",74,"243",10,"Prosocial","screentime",11,9,10,1,3,1,2,2,4,1,"older","0","1"
"1875",74,"243",11,"Antisocial","shower",3,5,3,2,4,-2,2,-2,4,1,"older","0","0"
"1876",74,"243",12,"Prosocial","speed",8,6,6,2,1,0,-1,2,4,1,"older","0","1"
"1877",75,"244",3,"Antisocial","redlights",3,5,2,2,2,-3,0,-2,5,2,"older","0","0"
"1878",75,"244",4,"Antisocial","noisedisturbance",3,5,4,2,3,-1,1,-2,5,2,"older","0","0"
"1879",75,"244",5,"Antisocial","shower",3,5,2,4,2,-3,-2,-2,5,2,"older","0","0"
"1880",75,"244",6,"Prosocial","organicVegetables",10,8,7,5,4,-1,-1,2,5,2,"older","0","1"
"1881",75,"244",7,"Prosocial","homeless",10,8,6,5,5,-2,0,2,5,2,"older","0","1"
"1882",75,"244",9,"Prosocial","vegetarian",8,6,6,2,4,0,2,2,5,2,"older","0","1"
"1883",75,"244",11,"Antisocial","gathering",4,6,3,3,3,-3,0,-2,5,2,"older","0","0"
"1884",75,"244",12,"Prosocial","washands",10,8,10,5,7,2,2,2,5,2,"older","0","1"
"1885",76,"245",1,"Antisocial","taxes",1,3,2,2,2,-1,0,-2,5,1,"older","0","0"
"1886",76,"245",2,"Prosocial","organicVegetables",10,8,9,6,6,1,0,2,5,1,"older","0","1"
"1887",76,"245",3,"Prosocial","homeless",8,6,5,2,2,-1,0,2,5,1,"older","0","1"
"1888",76,"245",7,"Prosocial","speed",8,6,6,2,4,0,2,2,5,1,"older","0","1"
"1889",76,"245",8,"Antisocial","travelticket",2,4,4,2,2,0,0,-2,5,1,"older","0","0"
"1890",76,"245",9,"Antisocial","redlights",1,3,1,2,1,-2,-1,-2,5,1,"older","0","0"
"1891",76,"245",10,"Antisocial","alcoholWork",4,6,6,4,4,0,0,-2,5,1,"older","0","0"
"1892",76,"245",11,"Prosocial","volunteer",11,9,11,5,7,2,2,2,5,1,"older","0","1"
"1893",77,"246",2,"Antisocial","late",4,6,5,3,1,-1,-2,-2,5,2,"older","0","0"
"1894",77,"246",3,"Prosocial","organicVegetables",8,6,7,5,4,1,-1,2,5,2,"older","0","1"
"1895",77,"246",4,"Prosocial","queue",10,8,11,6,5,3,-1,2,5,2,"older","0","1"
"1896",77,"246",6,"Antisocial","gathering",4,6,5,4,2,-1,-2,-2,5,2,"older","0","0"
"1897",77,"246",8,"Prosocial","screentime",7,5,6,2,4,1,2,2,5,2,"older","0","1"
"1898",77,"246",9,"Antisocial","shower",4,6,7,4,5,1,1,-2,5,2,"older","0","0"
"1899",77,"246",10,"Prosocial","vegetarian",8,6,6,1,2,0,1,2,5,2,"older","0","1"
"1900",77,"246",12,"Antisocial","meat",9,11,6,7,7,-5,0,-2,5,2,"older","0","0"
"1901",78,"247",1,"Antisocial","coughelbow",2,4,1,2,1,-3,-1,-2,4,1,"older","0","0"
"1902",78,"247",2,"Antisocial","distance",1,3,1,4,3,-2,-1,-2,4,1,"older","0","0"
"1903",78,"247",3,"Prosocial","speed",8,6,8,5,5,2,0,2,4,1,"older","0","1"
"1904",78,"247",4,"Prosocial","organicVegetables",11,9,11,6,7,2,1,2,4,1,"older","0","1"
"1905",78,"247",6,"Prosocial","queue",7,5,6,2,4,1,2,2,4,1,"older","0","1"
"1906",78,"247",7,"Prosocial","screentime",8,6,8,6,5,2,-1,2,4,1,"older","0","1"
"1907",78,"247",9,"Antisocial","chargers",4,6,5,7,5,-1,-2,-2,4,1,"older","0","0"
"1908",78,"247",10,"Antisocial","shower",4,6,5,3,2,-1,-1,-2,4,1,"older","0","0"
"1909",79,"248",1,"Prosocial","speed",10,8,5,3,3,-3,0,2,3,2,"older","0","1"
"1910",79,"248",3,"Prosocial","charity",11,9,11,5,7,2,2,2,3,2,"older","0","1"
"1911",79,"248",4,"Antisocial","late",2,4,3,4,6,-1,2,-2,3,2,"older","0","0"
"1912",79,"248",6,"Antisocial","heating",3,5,3,2,1,-2,-1,-2,3,2,"older","0","0"
"1913",79,"248",7,"Antisocial","alcoholWork",1,3,3,3,5,0,2,-2,3,2,"older","0","0"
"1914",79,"248",8,"Prosocial","lendMoney",5,3,3,1,2,0,1,2,3,2,"older","0","1"
"1915",79,"248",10,"Antisocial","noisedisturbance",3,5,2,5,3,-3,-2,-2,3,2,"older","0","0"
"1916",79,"248",11,"Prosocial","seatBus",10,8,10,3,5,2,2,2,3,2,"older","0","1"
"1917",80,"249",1,"Antisocial","gathering",3,5,5,2,3,0,1,-2,5,1,"older","0","0"
"1918",80,"249",3,"Prosocial","sustainable",6,4,5,1,4,1,3,2,5,1,"older","0","1"
"1919",80,"249",4,"Antisocial","meat",7,9,10,7,6,1,-1,-2,5,1,"older","0","0"
"1920",80,"249",7,"Prosocial","recycle",11,9,9,6,7,0,1,2,5,1,"older","0","1"
"1921",80,"249",8,"Prosocial","homeless",9,7,4,2,3,-3,1,2,5,1,"older","0","1"
"1922",80,"249",9,"Prosocial","queue",9,7,6,5,4,-1,-1,2,5,1,"older","0","1"
"1923",80,"249",10,"Antisocial","coughelbow",1,3,2,2,2,-1,0,-2,5,1,"older","0","0"
"1924",80,"249",12,"Antisocial","shower",5,7,3,3,2,-4,-1,-2,5,1,"older","0","0"
"1925",81,"250",1,"Prosocial","homeless",11,9,5,5,2,-4,-3,2,1,1,"older","0","1"
"1926",81,"250",2,"Antisocial","meat",9,11,10,7,7,-1,0,-2,1,1,"older","0","0"
"1927",81,"250",3,"Prosocial","queue",10,8,10,5,6,2,1,2,1,1,"older","0","1"
"1928",81,"250",6,"Antisocial","chargers",1,5,10,7,7,5,0,-4,1,1,"older","0","0"
"1929",81,"250",7,"Antisocial","lights",2,4,6,7,7,2,0,-2,1,1,"older","0","0"
"1930",81,"250",8,"Prosocial","screentime",11,9,1,1,1,-8,0,2,1,1,"older","0","1"
"1931",81,"250",9,"Antisocial","distance",9,11,5,2,1,-6,-1,-2,1,1,"older","0","0"
"1932",81,"250",11,"Prosocial","ownbag",10,8,9,1,2,1,1,2,1,1,"older","0","1"
"1933",82,"251",1,"Prosocial","homeless",10,8,10,4,6,2,2,2,4,2,"older","0","1"
"1934",82,"251",2,"Antisocial","garbage",1,3,2,2,1,-1,-1,-2,4,2,"older","0","0"
"1935",82,"251",5,"Antisocial","redlights",1,3,2,3,2,-1,-1,-2,4,2,"older","0","0"
"1936",82,"251",6,"Antisocial","chargers",4,6,5,5,4,-1,-1,-2,4,2,"older","0","0"
"1937",82,"251",9,"Prosocial","volunteer",8,6,8,4,4,2,0,2,4,2,"older","0","1"
"1938",82,"251",10,"Prosocial","speed",10,8,9,5,5,1,0,2,4,2,"older","0","1"
"1939",82,"251",11,"Antisocial","distance",3,5,2,6,2,-3,-4,-2,4,2,"older","0","0"
"1940",82,"251",12,"Prosocial","queue",11,9,11,5,5,2,0,2,4,2,"older","0","1"
"1941",83,"252",2,"Antisocial","download",4,6,8,6,6,2,0,-2,4,2,"older","0","0"
"1942",83,"252",4,"Prosocial","recycle",11,9,9,6,6,0,0,2,4,2,"older","0","1"
"1943",83,"252",6,"Prosocial","ownbag",10,8,9,6,6,1,0,2,4,2,"older","0","1"
"1944",83,"252",7,"Prosocial","speed",11,9,11,6,6,2,0,2,4,2,"older","0","1"
"1945",83,"252",8,"Antisocial","distance",6,8,9,6,6,1,0,-2,4,2,"older","0","0"
"1946",83,"252",9,"Antisocial","chargers",5,7,9,6,6,2,0,-2,4,2,"older","0","0"
"1947",83,"252",10,"Prosocial","volunteer",11,9,8,3,4,-1,1,2,4,2,"older","0","1"
"1948",83,"252",11,"Antisocial","alcoholWork",1,3,1,3,1,-2,-2,-2,4,2,"older","0","0"
"1949",84,"253",2,"Antisocial","shower",2,4,2,2,1,-2,-1,-2,5,1,"older","0","0"
"1950",84,"253",3,"Prosocial","vegetarian",11,9,6,4,7,-3,3,2,5,1,"older","0","1"
"1951",84,"253",6,"Antisocial","lights",1,3,1,6,1,-2,-5,-2,5,1,"older","0","0"
"1952",84,"253",7,"Antisocial","redlights",1,3,1,2,1,-2,-1,-2,5,1,"older","0","0"
"1953",84,"253",8,"Prosocial","sustainable",11,9,5,6,3,-4,-3,2,5,1,"older","0","1"
"1954",84,"253",10,"Antisocial","distance",6,8,8,5,1,0,-4,-2,5,1,"older","0","0"
"1955",84,"253",11,"Prosocial","volunteer",11,9,9,2,6,0,4,2,5,1,"older","0","1"
"1956",85,"254",1,"Antisocial","heating",3,5,3,5,1,-2,-4,-2,2,2,"older","0","0"
"1957",85,"254",2,"Prosocial","lendMoney",8,6,7,1,3,1,2,2,2,2,"older","0","1"
"1958",85,"254",3,"Prosocial","homeless",9,7,10,1,1,3,0,2,2,2,"older","0","1"
"1959",85,"254",4,"Prosocial","queue",9,7,8,1,2,1,1,2,2,2,"older","0","1"
"1960",85,"254",5,"Prosocial","speed",9,7,7,1,1,0,0,2,2,2,"older","0","1"
"1961",85,"254",8,"Antisocial","chargers",4,6,4,7,7,-2,0,-2,2,2,"older","0","0"
"1962",85,"254",9,"Antisocial","download",2,4,3,7,7,-1,0,-2,2,2,"older","0","0"
"1963",85,"254",12,"Antisocial","distance",8,11,11,7,7,0,0,-3,2,2,"older","0","0"
"1964",86,"255",1,"Prosocial","volunteer",10,8,6,5,5,-2,0,2,4,2,"older","0","1"
"1965",86,"255",2,"Prosocial","queue",9,7,6,5,4,-1,-1,2,4,2,"older","0","1"
"1966",86,"255",3,"Prosocial","organicVegetables",10,8,11,6,7,3,1,2,4,2,"older","0","1"
"1967",86,"255",4,"Antisocial","coughelbow",6,9,6,6,3,-3,-3,-3,4,2,"older","0","0"
"1968",86,"255",5,"Antisocial","distance",3,5,3,5,2,-2,-3,-2,4,2,"older","0","0"
"1969",86,"255",8,"Antisocial","download",2,4,11,7,7,7,0,-2,4,2,"older","0","0"
"1970",86,"255",9,"Prosocial","crossroad",10,8,11,3,7,3,4,2,4,2,"older","0","1"
"1971",86,"255",11,"Antisocial","late",4,6,6,2,2,0,0,-2,4,2,"older","0","0"
"1972",87,"256",4,"Prosocial","lendMoney",8,6,5,1,3,-1,2,2,3,1,"older","0","1"
"1973",87,"256",5,"Prosocial","homeless",8,6,6,1,4,0,3,2,3,1,"older","0","1"
"1974",87,"256",7,"Prosocial","speed",6,3,5,2,3,2,1,3,3,1,"older","0","1"
"1975",87,"256",12,"Antisocial","chargers",9,11,7,3,4,-4,1,-2,3,1,"older","0","0"
"1976",88,"257",2,"Prosocial","queue",9,7,6,4,4,-1,0,2,4,1,"older","0","1"
"1977",88,"257",3,"Antisocial","distance",4,6,6,6,7,0,1,-2,4,1,"older","0","0"
"1978",88,"257",5,"Prosocial","homeless",8,6,7,1,2,1,1,2,4,1,"older","0","1"
"1979",88,"257",6,"Antisocial","chargers",4,6,8,7,7,2,0,-2,4,1,"older","0","0"
"1980",88,"257",9,"Antisocial","gathering",4,6,8,5,6,2,1,-2,4,1,"older","0","0"
"1981",88,"257",10,"Prosocial","speed",9,7,9,1,3,2,2,2,4,1,"older","0","1"
"1982",88,"257",11,"Antisocial","meat",9,11,11,7,7,0,0,-2,4,1,"older","0","0"
"1983",88,"257",12,"Prosocial","organicVegetables",10,8,11,4,6,3,2,2,4,1,"older","0","1"
"1984",89,"258",2,"Prosocial","sustainable",7,5,6,1,2,1,1,2,5,1,"older","0","1"
"1985",89,"258",3,"Prosocial","homeless",8,6,4,1,1,-2,0,2,5,1,"older","0","1"
"1986",89,"258",4,"Prosocial","speed",7,5,9,5,4,4,-1,2,5,1,"older","0","1"
"1987",89,"258",5,"Antisocial","late",5,7,4,3,1,-3,-2,-2,5,1,"older","0","0"
"1988",89,"258",6,"Prosocial","organicVegetables",6,4,6,1,2,2,1,2,5,1,"older","0","1"
"1989",89,"258",9,"Antisocial","lights",4,6,3,4,2,-3,-2,-2,5,1,"older","0","0"
"1990",89,"258",10,"Antisocial","chargers",5,7,6,7,6,-1,-1,-2,5,1,"older","0","0"
"1991",89,"258",12,"Antisocial","meat",7,9,9,7,7,0,0,-2,5,1,"older","0","0"
"1992",90,"259",2,"Prosocial","homeless",8,6,6,1,2,0,1,2,1,2,"older","0","1"
"1993",90,"259",3,"Antisocial","shower",4,6,8,7,4,2,-3,-2,1,2,"older","0","0"
"1994",90,"259",4,"Antisocial","meat",9,11,11,7,7,0,0,-2,1,2,"older","0","0"
"1995",90,"259",7,"Prosocial","sustainable",8,6,6,1,4,0,3,2,1,2,"older","0","1"
"1996",90,"259",9,"Antisocial","lights",4,6,6,4,4,0,0,-2,1,2,"older","0","0"
"1997",90,"259",10,"Prosocial","queue",8,6,6,1,4,0,3,2,1,2,"older","0","1"
"1998",90,"259",11,"Antisocial","chargers",4,6,6,4,4,0,0,-2,1,2,"older","0","0"
"1999",90,"259",12,"Prosocial","volunteer",8,6,6,4,4,0,0,2,1,2,"older","0","1"
"2000",91,"260",1,"Antisocial","download",1,3,11,7,7,8,0,-2,1,1,"older","0","0"
"2001",91,"260",2,"Prosocial","vegetarian",8,6,11,1,2,5,1,2,1,1,"older","0","1"
"2002",91,"260",3,"Prosocial","organicVegetables",11,9,11,5,5,2,0,2,1,1,"older","0","1"
"2003",91,"260",8,"Antisocial","coughelbow",1,3,2,3,3,-1,0,-2,1,1,"older","0","0"
"2004",91,"260",9,"Antisocial","gathering",1,3,3,2,1,0,-1,-2,1,1,"older","0","0"
"2005",91,"260",10,"Prosocial","screentime",8,6,11,5,7,5,2,2,1,1,"older","0","1"
"2006",91,"260",11,"Prosocial","homeless",10,8,11,3,5,3,2,2,1,1,"older","0","1"
"2007",92,"261",1,"Prosocial","homeless",8,6,6,4,4,0,0,2,2,1,"older","0","1"
"2008",92,"261",3,"Antisocial","meat",9,11,10,7,6,-1,-1,-2,2,1,"older","0","0"
"2009",92,"261",6,"Antisocial","chargers",4,6,6,7,4,0,-3,-2,2,1,"older","0","0"
"2010",92,"261",8,"Prosocial","screentime",11,9,11,4,7,2,3,2,2,1,"older","0","1"
"2011",92,"261",9,"Antisocial","coughelbow",9,11,4,7,6,-7,-1,-2,2,1,"older","0","0"
"2012",92,"261",10,"Antisocial","heating",4,6,6,7,3,0,-4,-2,2,1,"older","0","0"
"2013",92,"261",11,"Prosocial","queue",10,8,10,4,6,2,2,2,2,1,"older","0","1"
"2014",92,"261",12,"Prosocial","lendMoney",8,6,6,3,4,0,1,2,2,1,"older","0","1"
"2015",93,"262",1,"Prosocial","volunteer",11,9,9,5,6,0,1,2,5,1,"older","0","1"
"2016",93,"262",3,"Antisocial","meat",7,9,10,7,6,1,-1,-2,5,1,"older","0","0"
"2017",93,"262",4,"Prosocial","sustainable",8,6,9,4,5,3,1,2,5,1,"older","0","1"
"2018",93,"262",5,"Prosocial","queue",8,6,7,3,5,1,2,2,5,1,"older","0","1"
"2019",93,"262",6,"Antisocial","coughelbow",6,8,7,7,5,-1,-2,-2,5,1,"older","0","0"
"2020",93,"262",7,"Prosocial","homeless",10,8,7,5,6,-1,1,2,5,1,"older","0","1"
"2021",93,"262",9,"Antisocial","lights",6,8,9,7,6,1,-1,-2,5,1,"older","0","0"
"2022",93,"262",11,"Antisocial","shower",6,8,4,5,4,-4,-1,-2,5,1,"older","0","0"
"2023",94,"263",3,"Prosocial","lendMoney",6,1,5,4,3,4,-1,5,2,1,"older","0","1"
"2024",94,"263",8,"Antisocial","distance",8,11,11,7,7,0,0,-3,2,1,"older","0","0"
"2025",94,"263",9,"Antisocial","alcoholWork",4,6,1,4,1,-5,-3,-2,2,1,"older","0","0"
"2026",94,"263",10,"Antisocial","meat",9,11,11,7,7,0,0,-2,2,1,"older","0","0"
"2027",95,"264",1,"Prosocial","recycle",10,8,11,2,5,3,3,2,6,1,"older","0","1"
"2028",95,"264",2,"Prosocial","bike",6,4,3,3,5,-1,2,2,6,1,"older","0","1"
"2029",95,"264",3,"Antisocial","lights",2,4,4,3,6,0,3,-2,6,1,"older","0","0"
"2030",95,"264",4,"Antisocial","shower",3,5,9,3,5,4,2,-2,6,1,"older","0","0"
"2031",95,"264",5,"Prosocial","ownbag",7,5,8,6,3,3,-3,2,6,1,"older","0","1"
"2032",95,"264",6,"Prosocial","sustainable",11,9,9,6,6,0,0,2,6,1,"older","0","1"
"2033",95,"264",7,"Antisocial","coughelbow",5,7,8,5,6,1,1,-2,6,1,"older","0","0"
"2034",95,"264",11,"Antisocial","gathering",1,3,10,5,3,7,-2,-2,6,1,"older","0","0"
"2035",96,"265",1,"Prosocial","facemask",8,6,6,2,4,0,2,2,4,1,"older","0","1"
"2036",96,"265",3,"Antisocial","redlights",2,4,6,3,4,2,1,-2,4,1,"older","0","0"
"2037",96,"265",4,"Antisocial","gathering",4,6,6,4,4,0,0,-2,4,1,"older","0","0"
"2038",96,"265",6,"Prosocial","volunteer",10,8,11,1,1,3,0,2,4,1,"older","0","1"
"2039",96,"265",7,"Prosocial","crossroad",10,8,10,4,5,2,1,2,4,1,"older","0","1"
"2040",96,"265",10,"Prosocial","bike",9,7,8,2,1,1,-1,2,4,1,"older","0","1"
"2041",96,"265",11,"Antisocial","chargers",4,6,2,7,4,-4,-3,-2,4,1,"older","0","0"
"2042",96,"265",12,"Antisocial","coughelbow",1,3,1,2,2,-2,0,-2,4,1,"older","0","0"
"2043",97,"266",1,"Prosocial","crossroad",11,9,11,3,7,2,4,2,4,2,"older","0","1"
"2044",97,"266",2,"Prosocial","vegetarian",9,7,9,1,3,2,2,2,4,2,"older","0","1"
"2045",97,"266",3,"Prosocial","lendMoney",9,7,7,1,5,0,4,2,4,2,"older","0","1"
"2046",97,"266",4,"Prosocial","queue",10,8,11,5,7,3,2,2,4,2,"older","0","1"
"2047",97,"266",5,"Antisocial","shower",3,5,4,3,3,-1,0,-2,4,2,"older","0","0"
"2048",97,"266",6,"Antisocial","distance",2,4,5,5,4,1,-1,-2,4,2,"older","0","0"
"2049",97,"266",8,"Antisocial","chargers",5,7,6,7,7,-1,0,-2,4,2,"older","0","0"
"2050",97,"266",10,"Antisocial","lights",2,4,2,4,3,-2,-1,-2,4,2,"older","0","0"
"2051",97,"266",11,"Antisocial","download",7,9,11,2,7,2,5,-2,4,2,"older","0","0"
"2052",98,"267",1,"Prosocial","lendMoney",8,6,6,1,4,0,3,2,2,2,"older","0","1"
"2053",98,"267",3,"Prosocial","queue",8,6,6,4,3,0,-1,2,2,2,"older","0","1"
"2054",98,"267",4,"Antisocial","download",4,6,6,7,4,0,-3,-2,2,2,"older","0","0"
"2055",98,"267",5,"Antisocial","distance",3,5,2,6,3,-3,-3,-2,2,2,"older","0","0"
"2056",98,"267",6,"Prosocial","sustainable",9,7,7,1,4,0,3,2,2,2,"older","0","1"
"2057",98,"267",8,"Prosocial","screentime",8,6,6,1,4,0,3,2,2,2,"older","0","1"
"2058",98,"267",10,"Antisocial","shower",4,6,6,7,4,0,-3,-2,2,2,"older","0","0"
"2059",98,"267",12,"Antisocial","lights",4,6,3,7,2,-3,-5,-2,2,2,"older","0","0"
"2060",99,"268",1,"Antisocial","gathering",4,6,4,5,3,-2,-2,-2,2,1,"older","0","0"
"2061",99,"268",2,"Prosocial","crossroad",11,9,10,5,7,1,2,2,2,1,"older","0","1"
"2062",99,"268",4,"Antisocial","coughelbow",4,6,4,4,3,-2,-1,-2,2,1,"older","0","0"
"2063",99,"268",5,"Prosocial","organicVegetables",10,8,8,5,5,0,0,2,2,1,"older","0","1"
"2064",99,"268",7,"Antisocial","download",3,5,4,3,3,-1,0,-2,2,1,"older","0","0"
"2065",99,"268",9,"Prosocial","sustainable",9,7,9,5,5,2,0,2,2,1,"older","0","1"
"2066",99,"268",11,"Antisocial","distance",1,3,4,5,4,1,-1,-2,2,1,"older","0","0"
"2067",99,"268",12,"Prosocial","washands",6,4,5,2,2,1,0,2,2,1,"older","0","1"
"2068",100,"269",1,"Prosocial","seatBus",9,7,9,6,6,2,0,2,3,1,"older","0","1"
"2069",100,"269",4,"Prosocial","bike",10,8,11,6,7,3,1,2,3,1,"older","0","1"
"2070",100,"269",7,"Antisocial","travelticket",1,3,1,2,1,-2,-1,-2,3,1,"older","0","0"
"2071",100,"269",8,"Prosocial","screentime",11,9,11,5,7,2,2,2,3,1,"older","0","1"
"2072",100,"269",9,"Antisocial","shower",3,5,1,3,1,-4,-2,-2,3,1,"older","0","0"
"2073",100,"269",10,"Antisocial","gathering",1,3,1,2,1,-2,-1,-2,3,1,"older","0","0"
"2074",100,"269",12,"Prosocial","charity",10,8,11,6,7,3,1,2,3,1,"older","0","1"
"2075",101,"270",1,"Antisocial","gathering",4,6,6,4,4,0,0,-2,3,1,"older","0","0"
"2076",101,"270",3,"Antisocial","distance",4,6,6,4,4,0,0,-2,3,1,"older","0","0"
"2077",101,"270",4,"Antisocial","lights",6,8,5,3,4,-3,1,-2,3,1,"older","0","0"
"2078",101,"270",6,"Prosocial","screentime",8,6,7,4,4,1,0,2,3,1,"older","0","1"
"2079",101,"270",7,"Prosocial","washands",10,8,9,3,3,1,0,2,3,1,"older","0","1"
"2080",101,"270",8,"Antisocial","download",5,7,6,4,4,-1,0,-2,3,1,"older","0","0"
"2081",101,"270",11,"Prosocial","vegetarian",7,5,6,1,2,1,1,2,3,1,"older","0","1"
"2082",101,"270",12,"Prosocial","sustainable",8,6,6,1,2,0,1,2,3,1,"older","0","1"
"2083",102,"271",1,"Antisocial","download",4,6,7,3,6,1,3,-2,3,2,"older","0","0"
"2084",102,"271",2,"Prosocial","volunteer",11,9,9,3,5,0,2,2,3,2,"older","0","1"
"2085",102,"271",4,"Prosocial","vegetarian",8,6,6,4,1,0,-3,2,3,2,"older","0","1"
"2086",102,"271",5,"Prosocial","lendMoney",8,6,8,1,5,2,4,2,3,2,"older","0","1"
"2087",102,"271",6,"Antisocial","shower",4,6,4,3,7,-2,4,-2,3,2,"older","0","0"
"2088",102,"271",9,"Prosocial","queue",8,6,5,1,4,-1,3,2,3,2,"older","0","1"
"2089",102,"271",11,"Antisocial","chargers",4,6,6,5,4,0,-1,-2,3,2,"older","0","0"
"2090",103,"272",1,"Prosocial","organicVegetables",8,6,10,5,5,4,0,2,5,1,"older","0","1"
"2091",103,"272",2,"Antisocial","shower",4,6,4,5,3,-2,-2,-2,5,1,"older","0","0"
"2092",103,"272",3,"Antisocial","meat",6,8,7,7,6,-1,-1,-2,5,1,"older","0","0"
"2093",103,"272",4,"Prosocial","speed",8,6,8,4,5,2,1,2,5,1,"older","0","1"
"2094",103,"272",8,"Antisocial","distance",3,5,2,2,2,-3,0,-2,5,1,"older","0","0"
"2095",103,"272",9,"Prosocial","seatBus",11,9,11,2,4,2,2,2,5,1,"older","0","1"
"2096",103,"272",10,"Prosocial","screentime",8,6,9,5,7,3,2,2,5,1,"older","0","1"
"2097",103,"272",11,"Antisocial","chargers",3,5,4,5,4,-1,-1,-2,5,1,"older","0","0"
"2098",104,"273",3,"Antisocial","coughelbow",9,11,11,6,7,0,1,-2,6,1,"older","0","0"
"2099",104,"273",4,"Antisocial","gathering",7,9,11,5,5,2,0,-2,6,1,"older","0","0"
"2100",104,"273",7,"Prosocial","sustainable",8,6,8,4,4,2,0,2,6,1,"older","0","1"
"2101",104,"273",8,"Prosocial","lendMoney",8,6,6,2,1,0,-1,2,6,1,"older","0","1"
"2102",104,"273",9,"Antisocial","distance",4,6,8,7,7,2,0,-2,6,1,"older","0","0"
"2103",104,"273",10,"Antisocial","heating",4,6,6,2,1,0,-1,-2,6,1,"older","0","0"
"2104",104,"273",12,"Prosocial","facemask",7,5,6,1,1,1,0,2,6,1,"older","0","1"
"2105",105,"274",2,"Antisocial","gathering",4,6,4,4,4,-2,0,-2,2,1,"older","0","0"
"2106",105,"274",3,"Prosocial","facemask",11,9,11,6,7,2,1,2,2,1,"older","0","1"
"2107",105,"274",5,"Prosocial","bike",11,9,10,1,2,1,1,2,2,1,"older","0","1"
"2108",105,"274",6,"Antisocial","late",1,3,4,3,2,1,-1,-2,2,1,"older","0","0"
"2109",105,"274",7,"Antisocial","alcoholWork",2,4,2,3,2,-2,-1,-2,2,1,"older","0","0"
"2110",105,"274",10,"Prosocial","lendMoney",8,6,7,1,4,1,3,2,2,1,"older","0","1"
"2111",105,"274",11,"Antisocial","coughelbow",1,3,3,4,4,0,0,-2,2,1,"older","0","0"
"2112",105,"274",12,"Prosocial","washands",11,9,11,4,4,2,0,2,2,1,"older","0","1"
"2113",106,"275",2,"Antisocial","coughelbow",4,6,6,5,3,0,-2,-2,6,2,"older","0","0"
"2114",106,"275",4,"Prosocial","screentime",11,9,6,5,5,-3,0,2,6,2,"older","0","1"
"2115",106,"275",7,"Prosocial","washands",6,3,6,1,1,3,0,3,6,2,"older","0","1"
"2116",106,"275",8,"Prosocial","facemask",8,6,6,1,1,0,0,2,6,2,"older","0","1"
"2117",106,"275",9,"Antisocial","chargers",1,4,5,4,3,1,-1,-3,6,2,"older","0","0"
"2118",106,"275",10,"Antisocial","meat",9,11,11,7,7,0,0,-2,6,2,"older","0","0"
"2119",106,"275",11,"Antisocial","lights",4,6,4,4,3,-2,-1,-2,6,2,"older","0","0"
"2120",107,"276",1,"Antisocial","chargers",3,5,2,3,2,-3,-1,-2,2,2,"older","0","0"
"2121",107,"276",2,"Antisocial","lights",2,4,2,4,1,-2,-3,-2,2,2,"older","0","0"
"2122",107,"276",4,"Antisocial","late",3,5,4,5,4,-1,-1,-2,2,2,"older","0","0"
"2123",107,"276",6,"Prosocial","queue",4,2,1,4,1,-1,-3,2,2,2,"older","0","1"
"2124",107,"276",7,"Prosocial","bike",10,8,10,3,3,2,0,2,2,2,"older","0","1"
"2125",107,"276",8,"Prosocial","homeless",9,7,8,3,3,1,0,2,2,2,"older","0","1"
"2126",107,"276",11,"Antisocial","shower",1,3,2,4,4,-1,0,-2,2,2,"older","0","0"
"2127",107,"276",12,"Prosocial","lendMoney",8,6,5,4,4,-1,0,2,2,2,"older","0","1"
"2128",108,"277",2,"Prosocial","organicVegetables",9,7,8,5,6,1,1,2,5,2,"older","0","1"
"2129",108,"277",4,"Antisocial","shower",2,4,2,3,2,-2,-1,-2,5,2,"older","0","0"
"2130",108,"277",5,"Antisocial","late",1,3,1,2,1,-2,-1,-2,5,2,"older","0","0"
"2131",108,"277",6,"Prosocial","recycle",11,9,10,3,5,1,2,2,5,2,"older","0","1"
"2132",108,"277",7,"Antisocial","distance",4,6,3,6,5,-3,-1,-2,5,2,"older","0","0"
"2133",108,"277",9,"Antisocial","alcoholWork",5,7,3,5,2,-4,-3,-2,5,2,"older","0","0"
"2134",108,"277",12,"Prosocial","sustainable",9,7,8,4,4,1,0,2,5,2,"older","0","1"
"2135",109,"278",1,"Prosocial","homeless",8,6,7,4,4,1,0,2,3,2,"older","0","1"
"2136",109,"278",2,"Antisocial","gathering",1,3,1,2,1,-2,-1,-2,3,2,"older","0","0"
"2137",109,"278",3,"Prosocial","organicVegetables",8,6,7,4,4,1,0,2,3,2,"older","0","1"
"2138",109,"278",4,"Antisocial","noisedisturbance",1,3,1,2,1,-2,-1,-2,3,2,"older","0","0"
"2139",109,"278",5,"Prosocial","facemask",11,9,11,6,7,2,1,2,3,2,"older","0","1"
"2140",109,"278",7,"Prosocial","screentime",8,6,9,4,6,3,2,2,3,2,"older","0","1"
"2141",109,"278",8,"Antisocial","download",1,3,2,2,2,-1,0,-2,3,2,"older","0","0"
"2142",109,"278",9,"Antisocial","chargers",4,6,6,6,4,0,-2,-2,3,2,"older","0","0"
"2143",110,"279",1,"Antisocial","shower",2,4,2,2,1,-2,-1,-2,6,1,"older","0","0"
"2144",110,"279",2,"Prosocial","queue",8,6,7,5,5,1,0,2,6,1,"older","0","1"
"2145",110,"279",3,"Prosocial","screentime",8,6,6,1,1,0,0,2,6,1,"older","0","1"
"2146",110,"279",5,"Antisocial","chargers",4,6,5,5,2,-1,-3,-2,6,1,"older","0","0"
"2147",110,"279",7,"Prosocial","volunteer",8,6,9,1,4,3,3,2,6,1,"older","0","1"
"2148",110,"279",10,"Prosocial","vegetarian",8,6,9,6,6,3,0,2,6,1,"older","0","1"
"2149",110,"279",12,"Antisocial","noisedisturbance",1,2,1,1,1,-1,0,-1,6,1,"older","0","0"
"2150",111,"280",1,"Antisocial","shower",1,3,2,4,3,-1,-1,-2,6,2,"older","0","0"
"2151",111,"280",2,"Antisocial","lights",1,3,2,2,2,-1,0,-2,6,2,"older","0","0"
"2152",111,"280",3,"Antisocial","late",2,4,2,2,2,-2,0,-2,6,2,"older","0","0"
"2153",111,"280",5,"Prosocial","seatBus",11,9,10,3,4,1,1,2,6,2,"older","0","1"
"2154",111,"280",6,"Antisocial","distance",3,5,4,5,3,-1,-2,-2,6,2,"older","0","0"
"2155",111,"280",9,"Prosocial","sustainable",11,9,11,4,6,2,2,2,6,2,"older","0","1"
"2156",111,"280",10,"Prosocial","lendMoney",8,6,6,2,2,0,0,2,6,2,"older","0","1"
"2157",111,"280",11,"Prosocial","vegetarian",10,8,11,3,4,3,1,2,6,2,"older","0","1"
"2158",112,"281",2,"Antisocial","chargers",4,6,3,4,2,-3,-2,-2,5,2,"older","0","0"
"2159",112,"281",3,"Prosocial","lendMoney",11,9,9,4,5,0,1,2,5,2,"older","0","1"
"2160",112,"281",4,"Prosocial","queue",8,6,8,5,5,2,0,2,5,2,"older","0","1"
"2161",112,"281",5,"Prosocial","homeless",8,6,6,5,4,0,-1,2,5,2,"older","0","1"
"2162",112,"281",6,"Antisocial","lights",4,6,3,4,2,-3,-2,-2,5,2,"older","0","0"
"2163",112,"281",7,"Prosocial","screentime",9,7,6,2,4,-1,2,2,5,2,"older","0","1"
"2164",112,"281",10,"Antisocial","download",4,6,6,4,4,0,0,-2,5,2,"older","0","0"
"2165",112,"281",11,"Antisocial","meat",8,10,10,7,6,0,-1,-2,5,2,"older","0","0"
"2166",113,"282",1,"Antisocial","chargers",1,3,1,7,5,-2,-2,-2,6,2,"older","0","0"
"2167",113,"282",2,"Antisocial","parking",4,6,6,5,3,0,-2,-2,6,2,"older","0","0"
"2168",113,"282",3,"Antisocial","distance",8,11,1,4,5,-10,1,-3,6,2,"older","0","0"
"2169",113,"282",4,"Prosocial","queue",6,3,6,1,4,3,3,3,6,2,"older","0","1"
"2170",113,"282",8,"Prosocial","lendMoney",8,6,8,1,2,2,1,2,6,2,"older","0","1"
"2171",113,"282",10,"Antisocial","shower",4,6,4,7,7,-2,0,-2,6,2,"older","0","0"
"2172",113,"282",11,"Prosocial","speed",8,6,11,4,7,5,3,2,6,2,"older","0","1"
"2173",113,"282",12,"Prosocial","homeless",8,6,8,2,5,2,3,2,6,2,"older","0","1"
"2174",114,"283",2,"Prosocial","volunteer",9,7,11,2,3,4,1,2,5,2,"older","0","1"
"2175",114,"283",3,"Antisocial","late",3,5,4,2,3,-1,1,-2,5,2,"older","0","0"
"2176",114,"283",4,"Antisocial","chargers",4,6,5,6,6,-1,0,-2,5,2,"older","0","0"
"2177",114,"283",6,"Prosocial","facemask",11,9,11,5,5,2,0,2,5,2,"older","0","1"
"2178",114,"283",7,"Prosocial","charity",10,8,11,6,7,3,1,2,5,2,"older","0","1"
"2179",114,"283",8,"Prosocial","bike",10,8,9,2,1,1,-1,2,5,2,"older","0","1"
"2180",114,"283",10,"Antisocial","lights",3,5,3,2,2,-2,0,-2,5,2,"older","0","0"
"2181",114,"283",11,"Antisocial","heating",4,6,6,5,5,0,0,-2,5,2,"older","0","0"
"2182",115,"284",2,"Prosocial","organicVegetables",8,6,8,4,4,2,0,2,5,2,"older","0","1"
"2183",115,"284",3,"Antisocial","alcoholWork",4,6,3,4,1,-3,-3,-2,5,2,"older","0","0"
"2184",115,"284",4,"Antisocial","meat",9,11,11,7,7,0,0,-2,5,2,"older","0","0"
"2185",115,"284",7,"Antisocial","chargers",4,6,6,7,7,0,0,-2,5,2,"older","0","0"
"2186",115,"284",9,"Antisocial","travelticket",1,6,1,1,1,-5,0,-5,5,2,"older","0","0"
"2187",115,"284",10,"Prosocial","vegetarian",8,6,8,1,4,2,3,2,5,2,"older","0","1"
"2188",115,"284",12,"Prosocial","lendMoney",9,7,6,1,1,-1,0,2,5,2,"older","0","1"
"2189",116,"285",2,"Prosocial","homeless",8,6,4,1,1,-2,0,2,6,2,"older","0","1"
"2190",116,"285",4,"Antisocial","download",1,3,2,3,3,-1,0,-2,6,2,"older","0","0"
"2191",116,"285",5,"Prosocial","bike",10,8,11,1,1,3,0,2,6,2,"older","0","1"
"2192",116,"285",6,"Prosocial","speed",9,7,11,6,6,4,0,2,6,2,"older","0","1"
"2193",116,"285",7,"Antisocial","distance",2,4,2,6,2,-2,-4,-2,6,2,"older","0","0"
"2194",116,"285",9,"Antisocial","chargers",4,6,4,7,5,-2,-2,-2,6,2,"older","0","0"
"2195",116,"285",11,"Prosocial","organicVegetables",8,6,7,1,2,1,1,2,6,2,"older","0","1"
"2196",116,"285",12,"Antisocial","lights",3,5,3,2,1,-2,-1,-2,6,2,"older","0","0"
"2197",117,"286",1,"Antisocial","garbage",1,3,1,2,1,-2,-1,-2,2,2,"older","0","0"
"2198",117,"286",3,"Prosocial","charity",10,8,7,5,3,-1,-2,2,2,2,"older","0","1"
"2199",117,"286",4,"Prosocial","crossroad",10,8,7,4,4,-1,0,2,2,2,"older","0","1"
"2200",117,"286",5,"Antisocial","alcoholWork",3,5,2,2,1,-3,-1,-2,2,2,"older","0","0"
"2201",117,"286",6,"Prosocial","sustainable",11,9,8,4,5,-1,1,2,2,2,"older","0","1"
"2202",117,"286",8,"Antisocial","shower",4,6,2,3,2,-4,-1,-2,2,2,"older","0","0"
"2203",117,"286",11,"Prosocial","washands",11,9,11,5,5,2,0,2,2,2,"older","0","1"
"2204",117,"286",12,"Antisocial","coughelbow",2,4,2,2,1,-2,-1,-2,2,2,"older","0","0"
"2205",118,"287",1,"Prosocial","organicVegetables",11,9,10,5,6,1,1,2,6,2,"older","0","1"
"2206",118,"287",4,"Prosocial","screentime",8,6,9,5,6,3,1,2,6,2,"older","0","1"
"2207",118,"287",7,"Prosocial","queue",11,9,9,5,6,0,1,2,6,2,"older","0","1"
"2208",118,"287",9,"Antisocial","meat",6,8,8,6,5,0,-1,-2,6,2,"older","0","0"
"2209",118,"287",10,"Prosocial","lendMoney",11,9,7,6,5,-2,-1,2,6,2,"older","0","1"
"2210",119,"288",1,"Prosocial","crossroad",10,8,11,1,7,3,6,2,6,2,"older","0","1"
"2211",119,"288",4,"Antisocial","chargers",9,11,11,7,7,0,0,-2,6,2,"older","0","0"
"2212",119,"288",5,"Antisocial","distance",4,6,8,5,6,2,1,-2,6,2,"older","0","0"
"2213",119,"288",6,"Antisocial","meat",9,11,11,7,7,0,0,-2,6,2,"older","0","0"
"2214",119,"288",7,"Prosocial","volunteer",9,7,11,1,1,4,0,2,6,2,"older","0","1"
"2215",119,"288",8,"Prosocial","lendMoney",11,9,11,1,2,2,1,2,6,2,"older","0","1"
"2216",119,"288",9,"Prosocial","recycle",11,9,11,5,6,2,1,2,6,2,"older","0","1"
"2217",119,"288",10,"Antisocial","gathering",6,8,10,3,6,2,3,-2,6,2,"older","0","0"
"2218",120,"289",1,"Antisocial","redlights",2,4,3,4,1,-1,-3,-2,2,1,"older","0","0"
"2219",120,"289",2,"Antisocial","gathering",1,3,7,2,5,4,3,-2,2,1,"older","0","0"
"2220",120,"289",3,"Prosocial","seatBus",6,4,8,3,7,4,4,2,2,1,"older","0","1"
"2221",120,"289",4,"Antisocial","download",5,7,11,6,7,4,1,-2,2,1,"older","0","0"
"2222",120,"289",6,"Prosocial","charity",10,8,11,2,7,3,5,2,2,1,"older","0","1"
"2223",120,"289",8,"Prosocial","crossroad",11,9,10,3,7,1,4,2,2,1,"older","0","1"
"2224",120,"289",9,"Prosocial","facemask",9,7,6,4,4,-1,0,2,2,1,"older","0","1"
"2225",120,"289",12,"Antisocial","heating",1,3,3,2,2,0,0,-2,2,1,"older","0","0"
"2226",121,"290",2,"Antisocial","download",7,10,4,2,1,-6,-1,-3,1,1,"older","0","0"
"2227",121,"290",3,"Antisocial","late",6,9,4,7,1,-5,-6,-3,1,1,"older","0","0"
"2228",121,"290",4,"Prosocial","homeless",8,6,5,2,1,-1,-1,2,1,1,"older","0","1"
"2229",121,"290",5,"Prosocial","ownbag",6,3,5,1,2,2,1,3,1,1,"older","0","1"
"2230",121,"290",6,"Antisocial","chargers",9,11,8,7,3,-3,-4,-2,1,1,"older","0","0"
"2231",121,"290",7,"Prosocial","sustainable",6,3,4,1,3,1,2,3,1,1,"older","0","1"
"2232",121,"290",8,"Prosocial","washands",6,3,1,6,6,-2,0,3,1,1,"older","0","1"
"2233",121,"290",12,"Antisocial","travelticket",6,10,5,2,1,-5,-1,-4,1,1,"older","0","0"
"2234",122,"291",3,"Prosocial","lendMoney",10,8,7,3,5,-1,2,2,4,2,"older","0","1"
"2235",122,"291",4,"Prosocial","facemask",9,7,10,4,7,3,3,2,4,2,"older","0","1"
"2236",122,"291",5,"Antisocial","distance",4,6,6,6,4,0,-2,-2,4,2,"older","0","0"
"2237",122,"291",6,"Antisocial","travelticket",2,4,2,2,4,-2,2,-2,4,2,"older","0","0"
"2238",122,"291",7,"Antisocial","shower",4,6,3,3,2,-3,-1,-2,4,2,"older","0","0"
"2239",122,"291",9,"Prosocial","vegetarian",11,10,7,5,4,-3,-1,1,4,2,"older","0","1"
"2240",122,"291",10,"Antisocial","lights",2,4,2,2,2,-2,0,-2,4,2,"older","0","0"
"2241",122,"291",12,"Prosocial","homeless",9,7,6,4,4,-1,0,2,4,2,"older","0","1"
"2242",123,"292",2,"Prosocial","crossroad",8,6,6,1,1,0,0,2,1,1,"older","0","1"
"2243",123,"292",3,"Antisocial","shower",4,6,5,7,7,-1,0,-2,1,1,"older","0","0"
"2244",123,"292",5,"Prosocial","vegetarian",8,6,6,1,1,0,0,2,1,1,"older","0","1"
"2245",123,"292",8,"Prosocial","homeless",8,6,8,1,3,2,2,2,1,1,"older","0","1"
"2246",123,"292",9,"Antisocial","lights",2,4,2,2,2,-2,0,-2,1,1,"older","0","0"
"2247",123,"292",10,"Antisocial","chargers",4,6,6,7,7,0,0,-2,1,1,"older","0","0"
"2248",123,"292",11,"Antisocial","coughelbow",4,6,6,4,4,0,0,-2,1,1,"older","0","0"
"2249",123,"292",12,"Prosocial","charity",8,6,8,1,1,2,0,2,1,1,"older","0","1"
"2250",124,"293",1,"Prosocial","lendMoney",8,6,6,4,4,0,0,2,4,1,"older","0","1"
"2251",124,"293",3,"Antisocial","redlights",1,3,1,2,1,-2,-1,-2,4,1,"older","0","0"
"2252",124,"293",5,"Prosocial","washands",7,5,3,1,2,-2,1,2,4,1,"older","0","1"
"2253",124,"293",6,"Prosocial","charity",8,6,11,2,7,5,5,2,4,1,"older","0","1"
"2254",124,"293",7,"Antisocial","shower",7,9,3,6,2,-6,-4,-2,4,1,"older","0","0"
"2255",124,"293",8,"Prosocial","vegetarian",10,8,9,6,6,1,0,2,4,1,"older","0","1"
"2256",124,"293",10,"Antisocial","meat",9,11,10,7,6,-1,-1,-2,4,1,"older","0","0"
"2257",124,"293",12,"Antisocial","chargers",8,10,6,7,4,-4,-3,-2,4,1,"older","0","0"
"2258",125,"294",1,"Prosocial","vegetarian",8,6,8,1,5,2,4,2,6,1,"older","0","1"
"2259",125,"294",2,"Antisocial","chargers",4,6,4,5,2,-2,-3,-2,6,1,"older","0","0"
"2260",125,"294",3,"Antisocial","lights",3,5,3,2,1,-2,-1,-2,6,1,"older","0","0"
"2261",125,"294",4,"Antisocial","shower",3,5,4,4,3,-1,-1,-2,6,1,"older","0","0"
"2262",125,"294",5,"Prosocial","lendMoney",9,7,8,3,5,1,2,2,6,1,"older","0","1"
"2263",125,"294",7,"Antisocial","distance",1,3,1,2,1,-2,-1,-2,6,1,"older","0","0"
"2264",125,"294",9,"Prosocial","bike",10,8,11,1,5,3,4,2,6,1,"older","0","1"
"2265",125,"294",12,"Prosocial","organicVegetables",11,9,11,4,6,2,2,2,6,1,"older","0","1"
"2266",126,"295",1,"Antisocial","noisedisturbance",4,6,4,4,1,-2,-3,-2,3,1,"older","0","0"
"2267",126,"295",3,"Antisocial","meat",9,11,11,7,7,0,0,-2,3,1,"older","0","0"
"2268",126,"295",4,"Antisocial","chargers",4,6,6,7,7,0,0,-2,3,1,"older","0","0"
"2269",126,"295",5,"Prosocial","homeless",8,6,6,4,3,0,-1,2,3,1,"older","0","1"
"2270",126,"295",9,"Prosocial","facemask",8,6,5,1,5,-1,4,2,3,1,"older","0","1"
"2271",126,"295",10,"Antisocial","gathering",6,8,9,7,1,1,-6,-2,3,1,"older","0","0"
"2272",126,"295",11,"Prosocial","lendMoney",8,6,6,4,2,0,-2,2,3,1,"older","0","1"
"2273",126,"295",12,"Prosocial","ownbag",8,6,6,4,2,0,-2,2,3,1,"older","0","1"
"2274",127,"296",1,"Prosocial","organicVegetables",8,6,2,5,4,-4,-1,2,4,2,"older","0","1"
"2275",127,"296",3,"Prosocial","volunteer",10,8,3,5,3,-5,-2,2,4,2,"older","0","1"
"2276",127,"296",5,"Prosocial","sustainable",8,6,6,3,5,0,2,2,4,2,"older","0","1"
"2277",127,"296",6,"Prosocial","speed",8,6,1,3,1,-5,-2,2,4,2,"older","0","1"
"2278",127,"296",9,"Antisocial","coughelbow",6,8,8,3,1,0,-2,-2,4,2,"older","0","0"
"2279",127,"296",10,"Antisocial","chargers",4,6,9,6,7,3,1,-2,4,2,"older","0","0"
"2280",127,"296",11,"Antisocial","heating",3,5,1,2,1,-4,-1,-2,4,2,"older","0","0"
"2281",127,"296",12,"Antisocial","noisedisturbance",2,4,7,4,2,3,-2,-2,4,2,"older","0","0"
"2282",128,"297",4,"Prosocial","bike",9,7,7,2,5,0,3,2,4,2,"older","0","1"
"2283",128,"297",5,"Prosocial","vegetarian",8,6,9,6,7,3,1,2,4,2,"older","0","1"
"2284",128,"297",6,"Antisocial","redlights",4,6,4,3,1,-2,-2,-2,4,2,"older","0","0"
"2285",128,"297",7,"Prosocial","homeless",11,9,10,3,6,1,3,2,4,2,"older","0","1"
"2286",128,"297",8,"Antisocial","chargers",5,7,5,4,4,-2,0,-2,4,2,"older","0","0"
"2287",128,"297",10,"Antisocial","gathering",3,5,6,6,4,1,-2,-2,4,2,"older","0","0"
"2288",128,"297",11,"Antisocial","lights",6,8,5,4,2,-3,-2,-2,4,2,"older","0","0"
"2289",128,"297",12,"Prosocial","facemask",9,7,10,1,5,3,4,2,4,2,"older","0","1"
"2290",129,"298",3,"Antisocial","shower",4,6,6,5,3,0,-2,-2,5,1,"older","0","0"
"2291",129,"298",4,"Antisocial","distance",7,9,7,5,5,-2,0,-2,5,1,"older","0","0"
"2292",129,"298",7,"Antisocial","gathering",3,5,7,2,4,2,2,-2,5,1,"older","0","0"
"2293",129,"298",8,"Prosocial","bike",10,8,8,1,2,0,1,2,5,1,"older","0","1"
"2294",129,"298",9,"Antisocial","chargers",4,6,8,7,6,2,-1,-2,5,1,"older","0","0"
"2295",129,"298",10,"Prosocial","organicVegetables",9,7,8,6,6,1,0,2,5,1,"older","0","1"
"2296",129,"298",12,"Prosocial","lendMoney",10,8,8,4,7,0,3,2,5,1,"older","0","1"
"2297",130,"299",2,"Prosocial","bike",11,9,11,1,2,2,1,2,4,1,"older","0","1"
"2298",130,"299",3,"Antisocial","distance",2,4,3,3,4,-1,1,-2,4,1,"older","0","0"
"2299",130,"299",5,"Prosocial","speed",11,9,10,6,7,1,1,2,4,1,"older","0","1"
"2300",130,"299",6,"Prosocial","screentime",8,6,11,2,6,5,4,2,4,1,"older","0","1"
"2301",130,"299",7,"Antisocial","lights",3,5,2,3,3,-3,0,-2,4,1,"older","0","0"
"2302",130,"299",9,"Prosocial","vegetarian",11,9,10,3,3,1,0,2,4,1,"older","0","1"
"2303",130,"299",10,"Antisocial","download",7,9,11,7,7,2,0,-2,4,1,"older","0","0"
"2304",130,"299",12,"Antisocial","meat",7,9,10,7,7,1,0,-2,4,1,"older","0","0"
"2305",131,"300",3,"Prosocial","speed",6,4,5,1,1,1,0,2,4,2,"older","0","1"
"2306",131,"300",6,"Prosocial","lendMoney",8,6,6,1,4,0,3,2,4,2,"older","0","1"
"2307",131,"300",7,"Antisocial","alcoholWork",4,6,6,5,6,0,1,-2,4,2,"older","0","0"
"2308",131,"300",8,"Antisocial","shower",1,3,2,4,3,-1,-1,-2,4,2,"older","0","0"
"2309",131,"300",9,"Prosocial","homeless",8,6,9,3,4,3,1,2,4,2,"older","0","1"
"2310",131,"300",10,"Antisocial","chargers",4,6,6,7,7,0,0,-2,4,2,"older","0","0"
"2311",131,"300",11,"Prosocial","queue",8,6,4,4,4,-2,0,2,4,2,"older","0","1"
"2312",132,"301",1,"Prosocial","volunteer",9,7,6,5,5,-1,0,2,3,2,"older","0","1"
"2313",132,"301",3,"Prosocial","homeless",9,7,8,4,5,1,1,2,3,2,"older","0","1"
"2314",132,"301",5,"Prosocial","recycle",10,8,9,5,6,1,1,2,3,2,"older","0","1"
"2315",132,"301",6,"Antisocial","noisedisturbance",3,5,4,2,3,-1,1,-2,3,2,"older","0","0"
"2316",132,"301",7,"Antisocial","distance",3,5,3,2,3,-2,1,-2,3,2,"older","0","0"
"2317",132,"301",9,"Antisocial","gathering",3,5,4,3,2,-1,-1,-2,3,2,"older","0","0"
"2318",132,"301",10,"Antisocial","lights",2,4,4,4,3,0,-1,-2,3,2,"older","0","0"
"2319",132,"301",11,"Prosocial","crossroad",10,8,10,4,6,2,2,2,3,2,"older","0","1"
"2320",133,"302",1,"Prosocial","homeless",8,6,7,1,3,1,2,2,3,1,"older","0","1"
"2321",133,"302",2,"Antisocial","coughelbow",2,4,1,2,1,-3,-1,-2,3,1,"older","0","0"
"2322",133,"302",3,"Prosocial","sustainable",11,9,11,6,7,2,1,2,3,1,"older","0","1"
"2323",133,"302",5,"Prosocial","queue",9,7,7,5,4,0,-1,2,3,1,"older","0","1"
"2324",133,"302",7,"Antisocial","chargers",3,5,6,7,4,1,-3,-2,3,1,"older","0","0"
"2325",133,"302",9,"Antisocial","distance",4,6,6,4,4,0,0,-2,3,1,"older","0","0"
"2326",133,"302",10,"Antisocial","gathering",2,4,6,2,3,2,1,-2,3,1,"older","0","0"
"2327",133,"302",11,"Prosocial","seatBus",11,9,11,4,6,2,2,2,3,1,"older","0","1"
"2328",134,"303",1,"Antisocial","distance",2,4,6,5,4,2,-1,-2,7,2,"older","0","0"
"2329",134,"303",2,"Prosocial","speed",8,6,6,2,5,0,3,2,7,2,"older","0","1"
"2330",134,"303",3,"Antisocial","download",4,6,6,4,5,0,1,-2,7,2,"older","0","0"
"2331",134,"303",4,"Prosocial","bike",10,8,11,2,7,3,5,2,7,2,"older","0","1"
"2332",134,"303",5,"Antisocial","chargers",3,5,2,2,1,-3,-1,-2,7,2,"older","0","0"
"2333",134,"303",6,"Prosocial","homeless",9,7,8,2,6,1,4,2,7,2,"older","0","1"
"2334",134,"303",7,"Prosocial","organicVegetables",8,6,10,5,7,4,2,2,7,2,"older","0","1"
"2335",134,"303",9,"Antisocial","coughelbow",9,11,11,7,7,0,0,-2,7,2,"older","0","0"
"2336",135,"304",1,"Prosocial","organicVegetables",8,6,6,4,1,0,-3,2,1,2,"older","0","1"
"2337",135,"304",2,"Antisocial","gathering",7,11,8,4,6,-3,2,-4,1,2,"older","0","0"
"2338",135,"304",3,"Antisocial","taxes",4,6,6,4,4,0,0,-2,1,2,"older","0","0"
"2339",135,"304",4,"Prosocial","facemask",3,1,1,1,1,0,0,2,1,2,"older","0","1"
"2340",135,"304",6,"Prosocial","queue",3,1,1,1,1,0,0,2,1,2,"older","0","1"
"2341",135,"304",10,"Antisocial","download",4,6,6,4,4,0,0,-2,1,2,"older","0","0"
"2342",135,"304",11,"Prosocial","homeless",8,6,8,4,5,2,1,2,1,2,"older","0","1"
"2343",136,"305",2,"Antisocial","shower",4,6,5,5,5,-1,0,-2,3,1,"older","0","0"
"2344",136,"305",3,"Prosocial","organicVegetables",7,5,4,2,2,-1,0,2,3,1,"older","0","1"
"2345",136,"305",4,"Antisocial","heating",3,5,6,2,2,1,0,-2,3,1,"older","0","0"
"2346",136,"305",6,"Antisocial","chargers",4,6,6,7,7,0,0,-2,3,1,"older","0","0"
"2347",136,"305",8,"Prosocial","homeless",8,6,6,1,1,0,0,2,3,1,"older","0","1"
"2348",136,"305",10,"Antisocial","late",3,5,3,2,1,-2,-1,-2,3,1,"older","0","0"
"2349",136,"305",11,"Prosocial","lendMoney",8,6,6,2,1,0,-1,2,3,1,"older","0","1"
"2350",136,"305",12,"Prosocial","crossroad",11,9,9,3,2,0,-1,2,3,1,"older","0","1"
"2351",137,"306",1,"Antisocial","taxes",2,4,2,3,1,-2,-2,-2,4,1,"older","0","0"
"2352",137,"306",2,"Prosocial","lendMoney",8,6,6,2,3,0,1,2,4,1,"older","0","1"
"2353",137,"306",5,"Prosocial","facemask",11,9,11,6,6,2,0,2,4,1,"older","0","1"
"2354",137,"306",7,"Prosocial","homeless",11,9,11,4,4,2,0,2,4,1,"older","0","1"
"2355",137,"306",9,"Antisocial","download",4,6,6,4,4,0,0,-2,4,1,"older","0","0"
"2356",137,"306",10,"Prosocial","vegetarian",11,9,11,2,2,2,0,2,4,1,"older","0","1"
"2357",137,"306",11,"Antisocial","coughelbow",1,3,2,3,3,-1,0,-2,4,1,"older","0","0"
"2358",137,"306",12,"Antisocial","distance",3,5,4,3,4,-1,1,-2,4,1,"older","0","0"
"2359",138,"307",2,"Antisocial","coughelbow",1,3,1,3,5,-2,2,-2,1,2,"older","0","0"
"2360",138,"307",3,"Antisocial","shower",7,9,10,7,7,1,0,-2,1,2,"older","0","0"
"2361",138,"307",6,"Antisocial","meat",6,8,11,7,7,3,0,-2,1,2,"older","0","0"
"2362",138,"307",10,"Antisocial","late",4,6,6,2,6,0,4,-2,1,2,"older","0","0"
"2363",138,"307",11,"Prosocial","speed",10,8,8,3,3,0,0,2,1,2,"older","0","1"
"2364",138,"307",12,"Prosocial","screentime",8,6,6,1,1,0,0,2,1,2,"older","0","1"
"2365",139,"308",1,"Antisocial","alcoholWork",3,5,5,4,2,0,-2,-2,6,2,"older","0","0"
"2366",139,"308",3,"Prosocial","seatBus",10,8,6,2,3,-2,1,2,6,2,"older","0","1"
"2367",139,"308",5,"Antisocial","heating",5,7,3,2,4,-4,2,-2,6,2,"older","0","0"
"2368",139,"308",7,"Antisocial","chargers",4,6,7,7,4,1,-3,-2,6,2,"older","0","0"
"2369",139,"308",8,"Prosocial","charity",11,9,6,2,3,-3,1,2,6,2,"older","0","1"
"2370",139,"308",9,"Prosocial","speed",6,4,3,1,2,-1,1,2,6,2,"older","0","1"
"2371",139,"308",11,"Prosocial","queue",7,5,3,2,2,-2,0,2,6,2,"older","0","1"
"2372",139,"308",12,"Antisocial","gathering",4,6,6,5,4,0,-1,-2,6,2,"older","0","0"
"2373",140,"309",1,"Prosocial","vegetarian",9,7,8,3,5,1,2,2,5,2,"older","0","1"
"2374",140,"309",3,"Antisocial","lights",2,4,7,2,2,3,0,-2,5,2,"older","0","0"
"2375",140,"309",4,"Antisocial","shower",7,9,10,5,6,1,1,-2,5,2,"older","0","0"
"2376",140,"309",7,"Antisocial","distance",5,7,11,5,7,4,2,-2,5,2,"older","0","0"
"2377",140,"309",9,"Prosocial","sustainable",8,6,6,2,2,0,0,2,5,2,"older","0","1"
"2378",140,"309",10,"Antisocial","coughelbow",9,11,11,7,7,0,0,-2,5,2,"older","0","0"
"2379",140,"309",11,"Prosocial","washands",11,9,9,6,5,0,-1,2,5,2,"older","0","1"
"2380",140,"309",12,"Prosocial","volunteer",6,4,1,1,1,-3,0,2,5,2,"older","0","1"
"2381",141,"310",1,"Antisocial","chargers",4,6,3,5,6,-3,1,-2,4,1,"older","0","0"
"2382",141,"310",2,"Prosocial","crossroad",11,9,10,2,6,1,4,2,4,1,"older","0","1"
"2383",141,"310",3,"Prosocial","vegetarian",10,8,7,4,4,-1,0,2,4,1,"older","0","1"
"2384",141,"310",5,"Antisocial","download",5,7,6,4,4,-1,0,-2,4,1,"older","0","0"
"2385",141,"310",7,"Antisocial","distance",4,6,6,4,3,0,-1,-2,4,1,"older","0","0"
"2386",141,"310",9,"Prosocial","charity",10,8,9,2,5,1,3,2,4,1,"older","0","1"
"2387",141,"310",10,"Prosocial","bike",8,6,6,1,3,0,2,2,4,1,"older","0","1"
"2388",141,"310",11,"Antisocial","lights",4,6,2,3,2,-4,-1,-2,4,1,"older","0","0"
"2389",142,"311",1,"Antisocial","download",4,6,4,4,4,-2,0,-2,2,2,"older","0","0"
"2390",142,"311",3,"Antisocial","taxes",4,6,4,4,1,-2,-3,-2,2,2,"older","0","0"
"2391",142,"311",4,"Prosocial","vegetarian",8,6,6,4,4,0,0,2,2,2,"older","0","1"
"2392",142,"311",7,"Prosocial","screentime",8,6,6,4,4,0,0,2,2,2,"older","0","1"
"2393",142,"311",8,"Antisocial","alcoholWork",4,6,6,4,4,0,0,-2,2,2,"older","0","0"
"2394",142,"311",9,"Prosocial","volunteer",8,6,6,4,4,0,0,2,2,2,"older","0","1"
"2395",142,"311",10,"Antisocial","chargers",9,11,6,4,4,-5,0,-2,2,2,"older","0","0"
"2396",143,"312",2,"Antisocial","meat",7,9,9,7,6,0,-1,-2,5,1,"older","0","0"
"2397",143,"312",3,"Prosocial","vegetarian",9,7,6,3,5,-1,2,2,5,1,"older","0","1"
"2398",143,"312",5,"Prosocial","ownbag",10,8,7,1,3,-1,2,2,5,1,"older","0","1"
"2399",143,"312",6,"Antisocial","shower",2,4,2,2,1,-2,-1,-2,5,1,"older","0","0"
"2400",143,"312",8,"Antisocial","gathering",4,6,7,6,5,1,-1,-2,5,1,"older","0","0"
"2401",143,"312",9,"Prosocial","facemask",3,1,2,1,1,1,0,2,5,1,"older","0","1"
"2402",143,"312",10,"Antisocial","coughelbow",9,11,11,7,7,0,0,-2,5,1,"older","0","0"
"2403",143,"312",11,"Prosocial","speed",7,5,5,1,5,0,4,2,5,1,"older","0","1"
"2404",144,"313",2,"Antisocial","late",4,6,5,3,3,-1,0,-2,2,1,"older","0","0"
"2405",144,"313",3,"Prosocial","crossroad",10,8,10,3,5,2,2,2,2,1,"older","0","1"
"2406",144,"313",4,"Prosocial","volunteer",9,7,10,3,4,3,1,2,2,1,"older","0","1"
"2407",144,"313",5,"Prosocial","lendMoney",10,8,6,1,3,-2,2,2,2,1,"older","0","1"
"2408",144,"313",6,"Antisocial","chargers",7,9,6,7,6,-3,-1,-2,2,1,"older","0","0"
"2409",144,"313",8,"Prosocial","washands",8,6,6,1,2,0,1,2,2,1,"older","0","1"
"2410",144,"313",9,"Antisocial","garbage",3,5,3,2,2,-2,0,-2,2,1,"older","0","0"
"2411",144,"313",10,"Antisocial","download",5,7,7,3,5,0,2,-2,2,1,"older","0","0"
"2412",145,"314",1,"Prosocial","crossroad",10,8,1,1,1,-7,0,2,2,2,"older","0","1"
"2413",145,"314",2,"Prosocial","charity",11,9,6,5,1,-3,-4,2,2,2,"older","0","1"
"2414",145,"314",5,"Antisocial","meat",9,11,11,7,7,0,0,-2,2,2,"older","0","0"
"2415",145,"314",6,"Antisocial","coughelbow",3,5,1,4,1,-4,-3,-2,2,2,"older","0","0"
"2416",145,"314",8,"Antisocial","distance",4,6,11,4,7,5,3,-2,2,2,"older","0","0"
"2417",145,"314",9,"Prosocial","queue",6,4,1,1,4,-3,3,2,2,2,"older","0","1"
"2418",145,"314",11,"Antisocial","late",5,7,11,6,7,4,1,-2,2,2,"older","0","0"
"2419",145,"314",12,"Prosocial","organicVegetables",11,9,6,4,4,-3,0,2,2,2,"older","0","1"
"2420",146,"315",2,"Antisocial","chargers",6,8,8,6,6,0,0,-2,2,2,"older","0","0"
"2421",146,"315",3,"Antisocial","shower",7,9,8,5,6,-1,1,-2,2,2,"older","0","0"
"2422",146,"315",4,"Antisocial","lights",3,5,4,5,2,-1,-3,-2,2,2,"older","0","0"
"2423",146,"315",5,"Prosocial","homeless",10,8,5,2,1,-3,-1,2,2,2,"older","0","1"
"2424",146,"315",6,"Antisocial","meat",9,11,11,7,7,0,0,-2,2,2,"older","0","0"
"2425",146,"315",8,"Prosocial","queue",10,8,6,2,4,-2,2,2,2,2,"older","0","1"
"2426",146,"315",9,"Prosocial","lendMoney",10,8,6,5,4,-2,-1,2,2,2,"older","0","1"
"2427",146,"315",11,"Prosocial","screentime",11,9,10,2,5,1,3,2,2,2,"older","0","1"
"2428",147,"316",1,"Prosocial","seatBus",9,7,9,5,6,2,1,2,4,1,"older","0","1"
"2429",147,"316",2,"Antisocial","chargers",1,3,3,3,2,0,-1,-2,4,1,"older","0","0"
"2430",147,"316",3,"Prosocial","speed",10,8,11,5,7,3,2,2,4,1,"older","0","1"
"2431",147,"316",5,"Antisocial","travelticket",3,5,2,3,3,-3,0,-2,4,1,"older","0","0"
"2432",147,"316",6,"Prosocial","ownbag",10,8,10,5,7,2,2,2,4,1,"older","0","1"
"2433",147,"316",7,"Prosocial","screentime",6,4,5,1,3,1,2,2,4,1,"older","0","1"
"2434",147,"316",10,"Antisocial","download",3,5,3,3,3,-2,0,-2,4,1,"older","0","0"
"2435",147,"316",11,"Antisocial","meat",6,8,7,5,5,-1,0,-2,4,1,"older","0","0"
"2436",148,"317",1,"Antisocial","meat",9,11,11,7,7,0,0,-2,2,2,"older","0","0"
"2437",148,"317",2,"Prosocial","screentime",8,6,5,4,4,-1,0,2,2,2,"older","0","1"
"2438",148,"317",3,"Antisocial","shower",7,9,3,6,3,-6,-3,-2,2,2,"older","0","0"
"2439",148,"317",7,"Prosocial","sustainable",10,8,8,6,5,0,-1,2,2,2,"older","0","1"
"2440",148,"317",8,"Antisocial","chargers",6,8,7,5,6,-1,1,-2,2,2,"older","0","0"
"2441",148,"317",9,"Prosocial","speed",11,9,8,6,5,-1,-1,2,2,2,"older","0","1"
"2442",148,"317",10,"Prosocial","lendMoney",8,6,3,3,3,-3,0,2,2,2,"older","0","1"
"2443",148,"317",11,"Antisocial","download",1,3,7,3,4,4,1,-2,2,2,"older","0","0"
"2444",149,"318",3,"Antisocial","coughelbow",4,6,9,4,4,3,0,-2,1,2,"older","0","0"
"2445",149,"318",4,"Antisocial","distance",8,10,1,7,1,-9,-6,-2,1,2,"older","0","0"
"2446",149,"318",5,"Antisocial","download",7,10,1,7,2,-9,-5,-3,1,2,"older","0","0"
"2447",149,"318",6,"Prosocial","charity",11,9,11,6,5,2,-1,2,1,2,"older","0","1"
"2448",149,"318",7,"Antisocial","meat",9,11,11,7,7,0,0,-2,1,2,"older","0","0"
"2449",149,"318",9,"Prosocial","volunteer",8,6,11,1,1,5,0,2,1,2,"older","0","1"
"2450",149,"318",10,"Prosocial","homeless",11,9,11,6,4,2,-2,2,1,2,"older","0","1"
"2451",149,"318",12,"Prosocial","sustainable",8,6,11,4,4,5,0,2,1,2,"older","0","1"
"2452",150,"319",3,"Antisocial","parking",1,3,3,2,2,0,0,-2,2,1,"older","0","0"
"2453",150,"319",4,"Prosocial","seatBus",8,6,8,4,3,2,-1,2,2,1,"older","0","1"
"2454",150,"319",5,"Prosocial","queue",10,8,9,5,3,1,-2,2,2,1,"older","0","1"
"2455",150,"319",6,"Antisocial","heating",4,6,5,2,3,-1,1,-2,2,1,"older","0","0"
"2456",150,"319",8,"Antisocial","coughelbow",2,4,1,3,2,-3,-1,-2,2,1,"older","0","0"
"2457",150,"319",9,"Antisocial","chargers",4,6,5,7,6,-1,-1,-2,2,1,"older","0","0"
"2458",150,"319",10,"Prosocial","screentime",9,7,7,3,3,0,0,2,2,1,"older","0","1"
"2459",150,"319",12,"Prosocial","recycle",11,9,11,6,6,2,0,2,2,1,"older","0","1"
"2460",151,"320",1,"Prosocial","facemask",9,7,9,6,6,2,0,2,5,2,"older","0","1"
"2461",151,"320",2,"Antisocial","meat",6,8,6,7,3,-2,-4,-2,5,2,"older","0","0"
"2462",151,"320",3,"Prosocial","lendMoney",8,6,5,3,5,-1,2,2,5,2,"older","0","1"
"2463",151,"320",5,"Antisocial","gathering",1,3,1,2,1,-2,-1,-2,5,2,"older","0","0"
"2464",151,"320",6,"Prosocial","organicVegetables",8,6,8,3,3,2,0,2,5,2,"older","0","1"
"2465",151,"320",7,"Prosocial","sustainable",11,9,8,2,5,-1,3,2,5,2,"older","0","1"
"2466",151,"320",8,"Antisocial","late",4,6,2,4,4,-4,0,-2,5,2,"older","0","0"
"2467",151,"320",9,"Antisocial","noisedisturbance",3,5,3,4,6,-2,2,-2,5,2,"older","0","0"
"2468",152,"321",1,"Antisocial","noisedisturbance",1,3,1,1,1,-2,0,-2,5,2,"older","0","0"
"2469",152,"321",2,"Antisocial","taxes",4,6,1,3,1,-5,-2,-2,5,2,"older","0","0"
"2470",152,"321",4,"Prosocial","seatBus",8,6,8,3,5,2,2,2,5,2,"older","0","1"
"2471",152,"321",7,"Prosocial","crossroad",11,9,9,4,4,0,0,2,5,2,"older","0","1"
"2472",152,"321",11,"Prosocial","speed",9,7,6,4,4,-1,0,2,5,2,"older","0","1"
"2473",152,"321",12,"Prosocial","vegetarian",8,6,11,4,6,5,2,2,5,2,"older","0","1"
"2474",153,"322",2,"Antisocial","shower",3,5,5,2,4,0,2,-2,4,1,"older","0","0"
"2475",153,"322",3,"Antisocial","coughelbow",2,4,1,2,1,-3,-1,-2,4,1,"older","0","0"
"2476",153,"322",5,"Prosocial","screentime",8,6,7,1,4,1,3,2,4,1,"older","0","1"
"2477",153,"322",8,"Prosocial","speed",11,9,11,6,5,2,-1,2,4,1,"older","0","1"
"2478",153,"322",9,"Antisocial","late",2,4,3,5,3,-1,-2,-2,4,1,"older","0","0"
"2479",153,"322",10,"Prosocial","vegetarian",11,9,10,5,7,1,2,2,4,1,"older","0","1"
"2480",153,"322",11,"Prosocial","volunteer",11,9,11,2,5,2,3,2,4,1,"older","0","1"
"2481",153,"322",12,"Antisocial","chargers",4,6,6,7,7,0,0,-2,4,1,"older","0","0"
"2482",154,"323",1,"Prosocial","screentime",9,7,9,5,7,2,2,2,7,1,"older","0","1"
"2483",154,"323",2,"Prosocial","lendMoney",7,5,5,1,2,0,1,2,7,1,"older","0","1"
"2484",154,"323",3,"Antisocial","download",1,3,3,3,1,0,-2,-2,7,1,"older","0","0"
"2485",154,"323",4,"Antisocial","chargers",5,7,8,7,7,1,0,-2,7,1,"older","0","0"
"2486",154,"323",6,"Antisocial","gathering",5,7,4,5,1,-3,-4,-2,7,1,"older","0","0"
"2487",154,"323",9,"Prosocial","facemask",10,8,9,4,7,1,3,2,7,1,"older","0","1"
"2488",154,"323",10,"Prosocial","crossroad",10,8,11,4,3,3,-1,2,7,1,"older","0","1"
"2489",154,"323",12,"Antisocial","garbage",3,5,3,4,5,-2,1,-2,7,1,"older","0","0"
"2490",155,"324",1,"Prosocial","seatBus",10,8,6,4,5,-2,1,2,2,2,"older","0","1"
"2491",155,"324",2,"Antisocial","shower",5,7,5,5,3,-2,-2,-2,2,2,"older","0","0"
"2492",155,"324",3,"Prosocial","bike",10,8,7,1,5,-1,4,2,2,2,"older","0","1"
"2493",155,"324",4,"Antisocial","chargers",4,6,5,5,4,-1,-1,-2,2,2,"older","0","0"
"2494",155,"324",5,"Antisocial","travelticket",3,5,3,2,2,-2,0,-2,2,2,"older","0","0"
"2495",155,"324",7,"Antisocial","meat",6,8,7,7,5,-1,-2,-2,2,2,"older","0","0"
"2496",155,"324",11,"Prosocial","lendMoney",8,6,3,2,3,-3,1,2,2,2,"older","0","1"
"2497",155,"324",12,"Prosocial","vegetarian",8,6,3,2,2,-3,0,2,2,2,"older","0","1"
"2498",156,"325",2,"Antisocial","download",6,8,8,3,5,0,2,-2,3,2,"older","0","0"
"2499",156,"325",4,"Prosocial","volunteer",7,5,8,3,1,3,-2,2,3,2,"older","0","1"
"2500",156,"325",5,"Prosocial","crossroad",8,4,8,3,5,4,2,4,3,2,"older","0","1"
"2501",156,"325",6,"Antisocial","chargers",9,11,11,7,7,0,0,-2,3,2,"older","0","0"
"2502",156,"325",7,"Prosocial","queue",3,1,1,1,1,0,0,2,3,2,"older","0","1"
"2503",156,"325",8,"Antisocial","meat",9,11,8,5,5,-3,0,-2,3,2,"older","0","0"
"2504",156,"325",9,"Prosocial","homeless",11,9,11,1,1,2,0,2,3,2,"older","0","1"
"2505",156,"325",12,"Antisocial","taxes",6,11,8,7,6,-3,-1,-5,3,2,"older","0","0"
"2506",157,"326",1,"Antisocial","chargers",4,6,6,4,4,0,0,-2,4,2,"older","0","0"
"2507",157,"326",3,"Prosocial","homeless",9,7,9,2,2,2,0,2,4,2,"older","0","1"
"2508",157,"326",5,"Prosocial","ownbag",11,9,9,5,6,0,1,2,4,2,"older","0","1"
"2509",157,"326",6,"Antisocial","download",4,6,6,2,4,0,2,-2,4,2,"older","0","0"
"2510",157,"326",7,"Antisocial","gathering",2,4,4,3,3,0,0,-2,4,2,"older","0","0"
"2511",157,"326",8,"Prosocial","charity",10,8,10,5,6,2,1,2,4,2,"older","0","1"
"2512",157,"326",9,"Prosocial","screentime",8,6,9,5,3,3,-2,2,4,2,"older","0","1"
"2513",157,"326",10,"Antisocial","distance",6,8,6,2,3,-2,1,-2,4,2,"older","0","0"
"2514",158,"327",1,"Antisocial","heating",4,6,8,7,4,2,-3,-2,2,2,"older","0","0"
"2515",158,"327",2,"Antisocial","distance",1,3,7,7,5,4,-2,-2,2,2,"older","0","0"
"2516",158,"327",4,"Prosocial","bike",8,6,7,1,1,1,0,2,2,2,"older","0","1"
"2517",158,"327",5,"Antisocial","lights",4,6,2,7,1,-4,-6,-2,2,2,"older","0","0"
"2518",158,"327",6,"Prosocial","organicVegetables",11,9,6,4,4,-3,0,2,2,2,"older","0","1"
"2519",158,"327",8,"Antisocial","meat",9,11,11,7,7,0,0,-2,2,2,"older","0","0"
"2520",158,"327",9,"Prosocial","homeless",6,4,1,1,1,-3,0,2,2,2,"older","0","1"
"2521",158,"327",11,"Prosocial","seatBus",8,6,6,1,1,0,0,2,2,2,"older","0","1"
"2522",159,"328",2,"Prosocial","crossroad",10,8,9,4,6,1,2,2,2,1,"older","0","1"
"2523",159,"328",3,"Prosocial","speed",11,9,8,6,3,-1,-3,2,2,1,"older","0","1"
"2524",159,"328",6,"Antisocial","meat",7,9,11,7,7,2,0,-2,2,1,"older","0","0"
"2525",159,"328",7,"Prosocial","queue",9,7,6,5,3,-1,-2,2,2,1,"older","0","1"
"2526",159,"328",9,"Antisocial","distance",4,6,3,3,2,-3,-1,-2,2,1,"older","0","0"
"2527",159,"328",10,"Antisocial","gathering",4,6,6,2,5,0,3,-2,2,1,"older","0","0"
"2528",159,"328",11,"Antisocial","chargers",1,3,3,7,6,0,-1,-2,2,1,"older","0","0"
"2529",159,"328",12,"Prosocial","bike",9,7,9,5,1,2,-4,2,2,1,"older","0","1"
"2530",160,"329",2,"Prosocial","lendMoney",11,9,10,4,6,1,2,2,4,1,"older","0","1"
"2531",160,"329",3,"Antisocial","late",1,3,2,2,2,-1,0,-2,4,1,"older","0","0"
"2532",160,"329",4,"Antisocial","lights",1,3,1,2,1,-2,-1,-2,4,1,"older","0","0"
"2533",160,"329",5,"Prosocial","vegetarian",9,7,11,5,7,4,2,2,4,1,"older","0","1"
"2534",160,"329",7,"Antisocial","download",3,5,3,3,3,-2,0,-2,4,1,"older","0","0"
"2535",160,"329",9,"Prosocial","speed",9,7,9,4,5,2,1,2,4,1,"older","0","1"
"2536",160,"329",10,"Prosocial","screentime",8,6,6,2,4,0,2,2,4,1,"older","0","1"
"2537",160,"329",11,"Antisocial","coughelbow",2,4,2,2,1,-2,-1,-2,4,1,"older","0","0"
"2538",161,"330",1,"Antisocial","gathering",5,7,6,4,6,-1,2,-2,3,2,"older","0","0"
"2539",161,"330",2,"Antisocial","chargers",7,9,7,6,7,-2,1,-2,3,2,"older","0","0"
"2540",161,"330",4,"Prosocial","sustainable",8,6,6,4,4,0,0,2,3,2,"older","0","1"
"2541",161,"330",6,"Prosocial","bike",9,7,9,3,4,2,1,2,3,2,"older","0","1"
"2542",161,"330",9,"Antisocial","coughelbow",2,4,4,4,3,0,-1,-2,3,2,"older","0","0"
"2543",161,"330",10,"Prosocial","facemask",8,6,6,2,5,0,3,2,3,2,"older","0","1"
"2544",161,"330",11,"Antisocial","shower",8,10,8,4,4,-2,0,-2,3,2,"older","0","0"
"2545",162,"331",1,"Antisocial","distance",3,5,6,4,6,1,2,-2,7,1,"older","0","0"
"2546",162,"331",2,"Prosocial","seatBus",9,7,6,4,4,-1,0,2,7,1,"older","0","1"
"2547",162,"331",3,"Antisocial","noisedisturbance",1,3,1,2,1,-2,-1,-2,7,1,"older","0","0"
"2548",162,"331",6,"Prosocial","queue",7,5,6,3,5,1,2,2,7,1,"older","0","1"
"2549",162,"331",7,"Prosocial","sustainable",10,8,8,4,4,0,0,2,7,1,"older","0","1"
"2550",162,"331",9,"Antisocial","shower",3,5,4,4,3,-1,-1,-2,7,1,"older","0","0"
"2551",162,"331",10,"Prosocial","washands",8,6,6,4,5,0,1,2,7,1,"older","0","1"
"2552",162,"331",11,"Antisocial","lights",4,6,6,4,5,0,1,-2,7,1,"older","0","0"
"2553",163,"332",1,"Prosocial","sustainable",8,6,9,2,4,3,2,2,5,2,"older","0","1"
"2554",163,"332",3,"Prosocial","bike",8,6,9,1,1,3,0,2,5,2,"older","0","1"
"2555",163,"332",4,"Antisocial","meat",9,11,11,7,7,0,0,-2,5,2,"older","0","0"
"2556",163,"332",5,"Antisocial","chargers",7,9,10,6,7,1,1,-2,5,2,"older","0","0"
"2557",163,"332",6,"Antisocial","shower",6,8,6,7,4,-2,-3,-2,5,2,"older","0","0"
"2558",163,"332",8,"Prosocial","speed",8,6,6,2,2,0,0,2,5,2,"older","0","1"
"2559",163,"332",10,"Prosocial","vegetarian",8,6,6,3,1,0,-2,2,5,2,"older","0","1"
"2560",163,"332",12,"Antisocial","lights",1,3,1,4,1,-2,-3,-2,5,2,"older","0","0"
"2561",164,"333",4,"Prosocial","recycle",8,3,6,1,4,3,3,5,2,2,"older","0","1"
"2562",164,"333",5,"Prosocial","facemask",3,1,2,2,1,1,-1,2,2,2,"older","0","1"
"2563",164,"333",6,"Antisocial","chargers",9,11,10,6,7,-1,1,-2,2,2,"older","0","0"
"2564",164,"333",7,"Antisocial","meat",9,11,10,7,7,-1,0,-2,2,2,"older","0","0"
"2565",164,"333",8,"Antisocial","shower",9,11,11,7,7,0,0,-2,2,2,"older","0","0"
"2566",164,"333",10,"Prosocial","ownbag",6,1,1,1,2,0,1,5,2,2,"older","0","1"
"2567",164,"333",11,"Prosocial","washands",6,3,2,1,6,-1,5,3,2,2,"older","0","1"
"2568",164,"333",12,"Antisocial","heating",4,6,2,2,4,-4,2,-2,2,2,"older","0","0"
"2569",165,"334",1,"Antisocial","shower",4,6,5,5,4,-1,-1,-2,2,1,"older","0","0"
"2570",165,"334",3,"Prosocial","homeless",9,7,7,1,2,0,1,2,2,1,"older","0","1"
"2571",165,"334",4,"Antisocial","meat",9,11,11,7,7,0,0,-2,2,1,"older","0","0"
"2572",165,"334",5,"Antisocial","distance",6,8,11,4,4,3,0,-2,2,1,"older","0","0"
"2573",165,"334",7,"Antisocial","chargers",1,3,1,1,1,-2,0,-2,2,1,"older","0","0"
"2574",165,"334",8,"Prosocial","charity",11,9,11,5,7,2,2,2,2,1,"older","0","1"
"2575",165,"334",10,"Antisocial","coughelbow",3,5,3,2,1,-2,-1,-2,2,1,"older","0","0"
"2576",165,"334",11,"Prosocial","bike",8,6,6,1,1,0,0,2,2,1,"older","0","1"
"2577",165,"334",12,"Prosocial","lendMoney",8,6,5,2,2,-1,0,2,2,1,"older","0","1"
"2578",166,"335",1,"Antisocial","gathering",3,5,2,4,3,-3,-1,-2,4,1,"older","0","0"
"2579",166,"335",2,"Antisocial","distance",4,6,2,3,3,-4,0,-2,4,1,"older","0","0"
"2580",166,"335",3,"Prosocial","vegetarian",8,6,6,1,3,0,2,2,4,1,"older","0","1"
"2581",166,"335",4,"Prosocial","lendMoney",10,8,10,6,5,2,-1,2,4,1,"older","0","1"
"2582",166,"335",5,"Prosocial","organicVegetables",8,6,6,5,2,0,-3,2,4,1,"older","0","1"
"2583",166,"335",7,"Antisocial","meat",9,11,11,7,7,0,0,-2,4,1,"older","0","0"
"2584",166,"335",8,"Prosocial","screentime",8,6,9,6,6,3,0,2,4,1,"older","0","1"
"2585",166,"335",10,"Antisocial","download",3,5,6,5,5,1,0,-2,4,1,"older","0","0"
"2586",167,"336",2,"Antisocial","alcoholWork",5,7,4,2,4,-3,2,-2,5,2,"older","0","0"
"2587",167,"336",3,"Prosocial","screentime",11,9,3,2,3,-6,1,2,5,2,"older","0","1"
"2588",167,"336",5,"Prosocial","recycle",11,9,10,6,6,1,0,2,5,2,"older","0","1"
"2589",167,"336",6,"Prosocial","charity",11,9,10,4,6,1,2,2,5,2,"older","0","1"
"2590",167,"336",7,"Antisocial","meat",7,9,10,6,7,1,1,-2,5,2,"older","0","0"
"2591",167,"336",10,"Antisocial","distance",3,5,4,2,3,-1,1,-2,5,2,"older","0","0"
"2592",167,"336",11,"Antisocial","download",5,7,3,5,4,-4,-1,-2,5,2,"older","0","0"
