"","participant_id","trial","Treatment","Beh","SI_PN","PN_1","PN_2","IB_1","IB_2","PN_moves","IB_moves","Treatment_GN","subCloseness","order"
"1","1",1,"Prosocial","vaccination",9,7,9,4,6,2,2,2,3,2
"2","1",3,"Prosocial","lendMoney",9,7,7,5,4,0,-1,2,3,2
"3","1",5,"Antisocial","coughelbow",1,3,4,2,3,1,1,-2,3,2
"4","1",7,"Antisocial","gathering",4,6,6,3,4,0,1,-2,3,2
"5","1",8,"Prosocial","screentime",8,6,7,3,4,1,1,2,3,2
"6","1",9,"Prosocial","queue",10,8,9,5,5,1,0,2,3,2
"7","1",10,"Antisocial","lights",3,5,5,3,4,0,1,-2,3,2
"8","1",12,"Antisocial","distance",4,6,5,4,3,-1,-1,-2,3,2
"9","2",3,"Antisocial","garbage",2,4,5,3,4,1,1,-2,2,2
"10","2",4,"Antisocial","noisedisturbance",4,6,7,7,5,1,-2,-2,2,2
"11","2",5,"Antisocial","gathering",5,7,6,6,2,-1,-4,-2,2,2
"12","2",6,"Antisocial","distance",9,11,10,5,6,-1,1,-2,2,2
"13","2",7,"Prosocial","vaccination",10,8,9,4,5,1,1,2,2,2
"14","2",8,"Prosocial","charity",11,9,11,1,2,2,1,2,2,2
"15","3",1,"Antisocial","distance",6,8,4,6,5,-4,-1,-2,4,1
"16","3",3,"Prosocial","organicVegetables",8,6,6,5,4,0,-1,2,4,1
"17","3",4,"Prosocial","bike",9,7,6,1,2,-1,1,2,4,1
"18","3",5,"Prosocial","seatBus",8,6,6,4,4,0,0,2,4,1
"19","3",7,"Antisocial","gathering",3,5,4,4,2,-1,-2,-2,4,1
"20","3",8,"Prosocial","screentime",8,6,6,4,6,0,2,2,4,1
"21","3",11,"Antisocial","shower",4,6,6,4,4,0,0,-2,4,1
"22","3",12,"Antisocial","chargers",4,6,6,5,5,0,0,-2,4,1
"23","4",1,"Antisocial","gathering",2,4,3,3,3,-1,0,-2,5,2
"24","4",2,"Prosocial","homeless",7,5,5,1,3,0,2,2,5,2
"25","4",3,"Antisocial","chargers",4,6,5,6,5,-1,-1,-2,5,2
"26","4",4,"Prosocial","lendMoney",9,7,7,1,2,0,1,2,5,2
"27","4",6,"Prosocial","queue",10,8,10,3,6,2,3,2,5,2
"28","4",9,"Prosocial","bike",10,8,9,1,3,1,2,2,5,2
"29","4",10,"Antisocial","redlights",2,4,2,2,1,-2,-1,-2,5,2
"30","4",11,"Antisocial","late",3,5,4,2,2,-1,0,-2,5,2
"31","5",1,"Prosocial","volunteer",10,8,9,4,5,1,1,2,2,2
"32","5",2,"Antisocial","gathering",4,6,3,4,2,-3,-2,-2,2,2
"33","5",5,"Prosocial","ownbag",11,9,9,4,6,0,2,2,2,2
"34","5",7,"Antisocial","shower",4,6,5,7,4,-1,-3,-2,2,2
"35","5",8,"Antisocial","lights",3,5,2,5,1,-3,-4,-2,2,2
"36","5",9,"Prosocial","bike",9,7,8,4,5,1,1,2,2,2
"37","5",10,"Antisocial","distance",8,10,8,5,5,-2,0,-2,2,2
"38","5",12,"Prosocial","homeless",10,8,9,5,6,1,1,2,2,2
"39","6",2,"Prosocial","organicVegetables",11,9,11,6,7,2,1,2,6,2
"40","6",3,"Prosocial","washands",11,9,11,6,7,2,1,2,6,2
"41","6",4,"Antisocial","distance",2,4,2,2,1,-2,-1,-2,6,2
"42","6",5,"Antisocial","coughelbow",4,6,4,3,2,-2,-1,-2,6,2
"43","6",6,"Prosocial","vegetarian",8,6,9,4,6,3,2,2,6,2
"44","6",7,"Antisocial","meat",6,8,6,6,4,-2,-2,-2,6,2
"45","6",8,"Antisocial","shower",4,6,4,4,4,-2,0,-2,6,2
"46","6",10,"Prosocial","screentime",8,6,8,3,6,2,3,2,6,2
"47","7",1,"Antisocial","heating",1,3,2,2,2,-1,0,-2,6,2
"48","7",3,"Prosocial","homeless",8,6,8,4,4,2,0,2,6,2
"49","7",5,"Prosocial","seatBus",8,6,7,4,6,1,2,2,6,2
"50","7",6,"Antisocial","coughelbow",6,8,9,4,7,1,3,-2,6,2
"51","7",7,"Prosocial","charity",8,6,7,5,4,1,-1,2,6,2
"52","7",10,"Prosocial","crossroad",8,6,8,4,4,2,0,2,6,2
"53","7",11,"Antisocial","shower",4,6,4,4,3,-2,-1,-2,6,2
"54","7",12,"Antisocial","alcoholWork",3,5,5,3,2,0,-1,-2,6,2
"55","8",1,"Prosocial","queue",11,9,9,4,6,0,2,2,2,1
"56","8",2,"Prosocial","bike",10,8,10,2,4,2,2,2,2,1
"57","8",4,"Prosocial","recycle",11,9,11,6,6,2,0,2,2,1
"58","8",5,"Antisocial","distance",8,10,9,6,7,-1,1,-2,2,1
"59","8",6,"Antisocial","gathering",2,4,2,2,1,-2,-1,-2,2,1
"60","8",7,"Prosocial","speed",11,9,11,6,7,2,1,2,2,1
"61","8",9,"Antisocial","shower",4,6,5,5,4,-1,-1,-2,2,1
"62","8",11,"Antisocial","chargers",4,6,3,5,3,-3,-2,-2,2,1
"63","9",1,"Antisocial","shower",3,5,3,2,2,-2,0,-2,5,2
"64","9",2,"Antisocial","late",2,4,2,2,1,-2,-1,-2,5,2
"65","9",4,"Prosocial","sustainable",10,8,9,1,5,1,4,2,5,2
"66","9",5,"Prosocial","charity",11,9,11,2,3,2,1,2,5,2
"67","9",6,"Antisocial","download",3,5,6,2,4,1,2,-2,5,2
"68","9",7,"Prosocial","organicVegetables",8,6,7,4,4,1,0,2,5,2
"69","9",9,"Antisocial","distance",4,6,6,5,3,0,-2,-2,5,2
"70","9",10,"Prosocial","lendMoney",8,6,7,1,1,1,0,2,5,2
"71","10",1,"Antisocial","gathering",4,6,6,7,4,0,-3,-2,4,1
"72","10",5,"Prosocial","organicVegetables",11,9,8,6,7,-1,1,2,4,1
"73","10",7,"Antisocial","coughelbow",4,6,6,2,5,0,3,-2,4,1
"74","10",8,"Prosocial","screentime",8,6,6,2,3,0,1,2,4,1
"75","10",9,"Prosocial","bike",11,9,6,1,5,-3,4,2,4,1
"76","10",10,"Prosocial","vegetarian",11,9,9,6,7,0,1,2,4,1
"77","11",1,"Prosocial","lendMoney",8,6,7,1,5,1,4,2,4,2
"78","11",2,"Prosocial","organicVegetables",10,8,9,5,6,1,1,2,4,2
"79","11",4,"Antisocial","chargers",1,3,3,7,5,0,-2,-2,4,2
"80","11",5,"Prosocial","homeless",8,6,7,4,4,1,0,2,4,2
"81","11",6,"Antisocial","gathering",2,4,2,3,2,-2,-1,-2,4,2
"82","11",8,"Antisocial","distance",9,11,9,6,6,-2,0,-2,4,2
"83","11",9,"Antisocial","heating",5,7,7,3,5,0,2,-2,4,2
"84","11",12,"Prosocial","screentime",8,6,7,2,5,1,3,2,4,2
"85","12",1,"Antisocial","meat",6,8,6,7,4,-2,-3,-2,2,2
"86","12",2,"Prosocial","lendMoney",8,6,4,4,3,-2,-1,2,2,2
"87","12",5,"Antisocial","distance",9,11,3,7,3,-8,-4,-2,2,2
"88","12",6,"Prosocial","screentime",10,8,11,1,7,3,6,2,2,2
"89","12",8,"Antisocial","shower",4,6,4,5,4,-2,-1,-2,2,2
"90","12",9,"Antisocial","lights",2,4,3,4,2,-1,-2,-2,2,2
"91","13",1,"Antisocial","coughelbow",4,6,3,2,1,-3,-1,-2,3,1
"92","13",2,"Prosocial","vaccination",7,5,2,1,1,-3,0,2,3,1
"93","13",6,"Antisocial","distance",9,11,10,7,7,-1,0,-2,3,1
"94","13",7,"Antisocial","shower",4,6,5,2,2,-1,0,-2,3,1
"95","13",8,"Prosocial","washands",8,6,6,1,2,0,1,2,3,1
"96","13",10,"Prosocial","sustainable",9,7,10,4,5,3,1,2,3,1
"97","13",11,"Prosocial","vegetarian",9,7,8,4,4,1,0,2,3,1
"98","13",12,"Antisocial","lights",4,6,5,2,2,-1,0,-2,3,1
"99","14",3,"Prosocial","facemask",8,6,6,3,4,0,1,2,3,1
"100","14",4,"Prosocial","homeless",8,6,4,2,1,-2,-1,2,3,1
"101","14",5,"Antisocial","chargers",1,4,1,2,1,-3,-1,-3,3,1
"102","14",6,"Prosocial","vaccination",8,6,6,1,1,0,0,2,3,1
"103","14",8,"Antisocial","gathering",4,6,6,2,2,0,0,-2,3,1
"104","14",9,"Antisocial","shower",4,6,6,4,5,0,1,-2,3,1
"105","14",11,"Prosocial","queue",11,9,11,4,7,2,3,2,3,1
"106","14",12,"Antisocial","coughelbow",1,3,1,2,1,-2,-1,-2,3,1
"107","15",4,"Antisocial","chargers",1,4,3,2,6,-1,4,-3,4,1
"108","15",5,"Prosocial","screentime",11,9,9,3,4,0,1,2,4,1
"109","15",6,"Prosocial","vegetarian",8,6,6,1,1,0,0,2,4,1
"110","15",9,"Prosocial","queue",11,9,10,5,7,1,2,2,4,1
"111","15",10,"Antisocial","travelticket",1,8,6,1,4,-2,3,-7,4,1
"112","15",11,"Antisocial","redlights",3,5,2,3,5,-3,2,-2,4,1
"113","15",12,"Prosocial","seatBus",11,9,10,6,5,1,-1,2,4,1
"114","16",1,"Antisocial","distance",6,8,2,2,2,-6,0,-2,5,2
"115","16",4,"Prosocial","queue",11,9,10,5,5,1,0,2,5,2
"116","16",6,"Antisocial","download",6,8,7,2,6,-1,4,-2,5,2
"117","16",7,"Antisocial","redlights",3,5,5,2,4,0,2,-2,5,2
"118","16",8,"Antisocial","shower",5,7,6,6,7,-1,1,-2,5,2
"119","16",9,"Prosocial","screentime",11,9,9,1,5,0,4,2,5,2
"120","16",11,"Prosocial","lendMoney",9,7,9,2,3,2,1,2,5,2
"121","16",12,"Prosocial","washands",9,7,11,5,6,4,1,2,5,2
"122","17",1,"Prosocial","queue",8,6,9,4,6,3,2,2,5,2
"123","17",3,"Antisocial","distance",6,9,6,7,4,-3,-3,-3,5,2
"124","17",5,"Prosocial","bike",8,6,10,1,4,4,3,2,5,2
"125","17",7,"Prosocial","organicVegetables",8,6,9,6,5,3,-1,2,5,2
"126","17",8,"Antisocial","shower",3,5,3,2,2,-2,0,-2,5,2
"127","17",9,"Antisocial","chargers",4,6,5,6,4,-1,-2,-2,5,2
"128","17",11,"Antisocial","download",3,6,6,2,5,0,3,-3,5,2
"129","17",12,"Prosocial","speed",8,6,6,1,5,0,4,2,5,2
"130","18",2,"Antisocial","alcoholWork",1,3,1,1,1,-2,0,-2,3,2
"131","18",3,"Prosocial","lendMoney",8,6,11,5,7,5,2,2,3,2
"132","18",4,"Prosocial","screentime",8,6,11,2,2,5,0,2,3,2
"133","18",5,"Antisocial","shower",7,10,11,7,7,1,0,-3,3,2
"134","18",6,"Prosocial","bike",9,7,11,1,3,4,2,2,3,2
"135","18",7,"Antisocial","gathering",6,8,1,2,2,-7,0,-2,3,2
"136","18",9,"Antisocial","chargers",4,6,6,6,5,0,-1,-2,3,2
"137","18",11,"Prosocial","queue",6,4,1,2,2,-3,0,2,3,2
"138","18",12,"Antisocial","lights",3,5,6,5,2,1,-3,-2,3,2
"139","19",2,"Prosocial","homeless",10,8,9,3,4,1,1,2,4,1
"140","19",5,"Antisocial","taxes",2,4,3,4,2,-1,-2,-2,4,1
"141","19",7,"Antisocial","chargers",4,6,6,4,5,0,1,-2,4,1
"142","19",8,"Antisocial","gathering",1,3,4,3,2,1,-1,-2,4,1
"143","19",9,"Antisocial","distance",3,5,3,5,2,-2,-3,-2,4,1
"144","19",10,"Prosocial","bike",11,9,9,2,3,0,1,2,4,1
"145","19",11,"Prosocial","seatBus",11,9,8,4,3,-1,-1,2,4,1
"146","19",12,"Prosocial","organicVegetables",10,8,8,5,6,0,1,2,4,1
"147","20",2,"Prosocial","facemask",9,7,6,4,5,-1,1,2,1,1
"148","20",3,"Prosocial","vaccination",7,5,6,1,1,1,0,2,1,1
"149","20",4,"Prosocial","sustainable",11,9,11,4,7,2,3,2,1,1
"150","20",5,"Antisocial","shower",5,7,6,4,5,-1,1,-2,1,1
"151","20",6,"Antisocial","gathering",1,3,5,4,1,2,-3,-2,1,1
"152","20",7,"Antisocial","meat",6,8,6,7,7,-2,0,-2,1,1
"153","20",8,"Antisocial","chargers",4,6,6,7,4,0,-3,-2,1,1
"154","20",9,"Prosocial","lendMoney",8,6,6,1,2,0,1,2,1,1
"155","21",2,"Antisocial","alcoholWork",4,6,4,6,4,-2,-2,-2,4,1
"156","21",3,"Prosocial","sustainable",10,8,8,6,4,0,-2,2,4,1
"157","21",4,"Prosocial","organicVegetables",8,6,7,5,2,1,-3,2,4,1
"158","21",6,"Antisocial","lights",4,6,1,6,1,-5,-5,-2,4,1
"159","21",7,"Prosocial","vegetarian",11,9,6,6,6,-3,0,2,4,1
"160","21",8,"Antisocial","distance",4,6,6,6,5,0,-1,-2,4,1
"161","21",10,"Antisocial","shower",4,6,7,6,1,1,-5,-2,4,1
"162","21",12,"Prosocial","speed",10,8,11,4,5,3,1,2,4,1
"163","22",1,"Antisocial","shower",2,4,1,2,6,-3,4,-2,4,2
"164","22",2,"Prosocial","speed",8,6,6,2,1,0,-1,2,4,2
"165","22",3,"Prosocial","lendMoney",9,7,6,6,4,-1,-2,2,4,2
"166","22",6,"Antisocial","download",3,6,6,4,4,0,0,-3,4,2
"167","22",7,"Antisocial","chargers",4,6,6,6,6,0,0,-2,4,2
"168","22",8,"Prosocial","screentime",8,6,6,4,7,0,3,2,4,2
"169","22",9,"Prosocial","organicVegetables",8,6,3,1,1,-3,0,2,4,2
"170","22",10,"Antisocial","distance",9,11,11,7,7,0,0,-2,4,2
"171","23",1,"Antisocial","heating",3,5,6,4,5,1,1,-2,2,2
"172","23",2,"Prosocial","queue",11,9,10,3,5,1,2,2,2,2
"173","23",3,"Prosocial","lendMoney",3,1,3,1,1,2,0,2,2,2
"174","23",6,"Prosocial","crossroad",9,7,7,1,3,0,2,2,2,2
"175","23",7,"Prosocial","organicVegetables",8,6,6,1,2,0,1,2,2,2
"176","23",8,"Antisocial","meat",9,11,9,7,7,-2,0,-2,2,2
"177","23",10,"Antisocial","distance",2,4,2,6,2,-2,-4,-2,2,2
"178","23",11,"Antisocial","chargers",4,6,6,7,7,0,0,-2,2,2
"179","24",2,"Prosocial","charity",11,9,10,5,6,1,1,2,6,1
"180","24",3,"Prosocial","vegetarian",10,8,8,2,5,0,3,2,6,1
"181","24",4,"Antisocial","download",5,7,7,2,6,0,4,-2,6,1
"182","24",7,"Antisocial","lights",5,7,7,5,5,0,0,-2,6,1
"183","24",8,"Antisocial","distance",2,4,5,5,3,1,-2,-2,6,1
"184","24",9,"Antisocial","meat",6,8,6,7,6,-2,-1,-2,6,1
"185","24",11,"Prosocial","screentime",9,7,7,1,3,0,2,2,6,1
"186","24",12,"Prosocial","speed",11,9,8,3,6,-1,3,2,6,1
"187","25",1,"Antisocial","lights",1,3,3,3,3,0,0,-2,2,1
"188","25",2,"Antisocial","heating",3,5,3,2,3,-2,1,-2,2,1
"189","25",4,"Antisocial","shower",4,6,5,4,4,-1,0,-2,2,1
"190","25",5,"Prosocial","screentime",8,6,6,4,2,0,-2,2,2,1
"191","25",6,"Antisocial","distance",9,11,11,7,7,0,0,-2,2,1
"192","25",7,"Prosocial","homeless",10,8,7,5,4,-1,-1,2,2,1
"193","25",9,"Prosocial","organicVegetables",10,8,9,6,6,1,0,2,2,1
"194","25",10,"Prosocial","vegetarian",11,9,9,5,6,0,1,2,2,1
"195","26",1,"Antisocial","shower",1,2,10,1,4,8,3,-1,7,2
"196","26",2,"Prosocial","queue",8,6,10,4,1,4,-3,2,7,2
"197","26",8,"Prosocial","lendMoney",3,1,10,1,2,9,1,2,7,2
"198","26",9,"Prosocial","speed",8,6,10,4,5,4,1,2,7,2
"199","26",10,"Antisocial","distance",9,11,10,7,7,-1,0,-2,7,2
"200","26",12,"Antisocial","meat",8,10,11,7,7,1,0,-2,7,2
"201","27",1,"Prosocial","recycle",8,6,9,5,5,3,0,2,4,1
"202","27",2,"Prosocial","vegetarian",8,6,8,4,5,2,1,2,4,1
"203","27",5,"Antisocial","gathering",4,6,4,2,4,-2,2,-2,4,1
"204","27",7,"Prosocial","vaccination",8,6,8,4,4,2,0,2,4,1
"205","27",8,"Antisocial","shower",4,6,4,2,3,-2,1,-2,4,1
"206","27",10,"Prosocial","facemask",8,6,7,1,4,1,3,2,4,1
"207","27",11,"Antisocial","distance",4,6,4,2,4,-2,2,-2,4,1
"208","27",12,"Antisocial","lights",4,6,6,4,4,0,0,-2,4,1
"209","28",1,"Prosocial","lendMoney",9,7,8,5,6,1,1,2,5,2
"210","28",2,"Antisocial","redlights",1,3,3,2,2,0,0,-2,5,2
"211","28",4,"Prosocial","crossroad",11,9,9,6,6,0,0,2,5,2
"212","28",5,"Prosocial","organicVegetables",10,8,7,6,5,-1,-1,2,5,2
"213","28",6,"Antisocial","shower",2,4,4,3,4,0,1,-2,5,2
"214","28",9,"Antisocial","coughelbow",2,4,3,2,2,-1,0,-2,5,2
"215","28",11,"Antisocial","late",1,3,2,2,3,-1,1,-2,5,2
"216","28",12,"Prosocial","homeless",11,9,8,5,5,-1,0,2,5,2
"217","29",1,"Prosocial","homeless",8,6,7,4,2,1,-2,2,4,1
"218","29",3,"Prosocial","lendMoney",9,7,3,3,1,-4,-2,2,4,1
"219","29",4,"Prosocial","vegetarian",10,8,11,5,5,3,0,2,4,1
"220","29",5,"Antisocial","noisedisturbance",1,3,1,2,1,-2,-1,-2,4,1
"221","29",6,"Antisocial","shower",3,5,6,5,6,1,1,-2,4,1
"222","29",7,"Antisocial","meat",7,9,8,7,7,-1,0,-2,4,1
"223","29",10,"Prosocial","speed",8,6,8,2,5,2,3,2,4,1
"224","29",12,"Antisocial","late",2,4,2,4,5,-2,1,-2,4,1
"225","30",1,"Prosocial","crossroad",10,8,10,4,6,2,2,2,4,1
"226","30",2,"Prosocial","vegetarian",10,8,10,4,6,2,2,2,4,1
"227","30",3,"Antisocial","lights",3,5,2,4,2,-3,-2,-2,4,1
"228","30",5,"Prosocial","organicVegetables",9,7,8,4,5,1,1,2,4,1
"229","30",6,"Antisocial","coughelbow",2,4,2,2,2,-2,0,-2,4,1
"230","30",8,"Prosocial","sustainable",10,8,9,4,6,1,2,2,4,1
"231","30",10,"Antisocial","parking",2,4,2,5,2,-2,-3,-2,4,1
"232","30",12,"Antisocial","shower",3,5,3,5,2,-2,-3,-2,4,1
"233","31",1,"Antisocial","coughelbow",1,3,2,2,2,-1,0,-2,3,1
"234","31",3,"Prosocial","lendMoney",9,7,7,2,2,0,0,2,3,1
"235","31",6,"Antisocial","meat",6,8,7,6,5,-1,-1,-2,3,1
"236","31",7,"Antisocial","heating",1,2,2,2,1,0,-1,-1,3,1
"237","31",8,"Prosocial","crossroad",11,9,11,5,6,2,1,2,3,1
"238","31",9,"Prosocial","sustainable",11,9,11,5,5,2,0,2,3,1
"239","31",10,"Prosocial","vegetarian",10,8,10,6,6,2,0,2,3,1
"240","31",11,"Antisocial","shower",4,6,5,3,4,-1,1,-2,3,1
"241","32",1,"Prosocial","homeless",6,4,4,3,5,0,2,2,1,1
"242","32",2,"Antisocial","chargers",4,6,5,6,3,-1,-3,-2,1,1
"243","32",3,"Prosocial","lendMoney",6,4,5,1,5,1,4,2,1,1
"244","32",4,"Antisocial","noisedisturbance",3,5,5,2,3,0,1,-2,1,1
"245","32",6,"Antisocial","distance",9,11,10,7,6,-1,-1,-2,1,1
"246","32",8,"Antisocial","coughelbow",6,8,6,6,7,-2,1,-2,1,1
"247","32",9,"Prosocial","screentime",8,6,9,1,6,3,5,2,1,1
"248","32",11,"Prosocial","crossroad",9,7,9,4,6,2,2,2,1,1
"249","33",1,"Antisocial","shower",4,6,3,2,1,-3,-1,-2,5,1
"250","33",2,"Antisocial","meat",9,11,6,7,7,-5,0,-2,5,1
"251","33",4,"Prosocial","homeless",8,6,3,1,1,-3,0,2,5,1
"252","33",6,"Antisocial","gathering",7,10,6,4,1,-4,-3,-3,5,1
"253","33",8,"Prosocial","washands",8,6,2,2,4,-4,2,2,5,1
"254","33",9,"Antisocial","chargers",9,11,6,6,4,-5,-2,-2,5,1
"255","33",11,"Prosocial","screentime",8,6,3,2,1,-3,-1,2,5,1
"256","33",12,"Prosocial","lendMoney",3,1,1,1,1,0,0,2,5,1
"257","34",1,"Antisocial","chargers",4,6,6,7,5,0,-2,-2,3,2
"258","34",2,"Antisocial","lights",4,6,6,6,2,0,-4,-2,3,2
"259","34",3,"Prosocial","lendMoney",9,7,8,4,5,1,1,2,3,2
"260","34",4,"Antisocial","late",1,3,1,5,1,-2,-4,-2,3,2
"261","34",5,"Prosocial","queue",11,9,9,4,5,0,1,2,3,2
"262","34",6,"Prosocial","screentime",11,9,10,1,7,1,6,2,3,2
"263","34",9,"Prosocial","speed",11,9,10,5,7,1,2,2,3,2
"264","34",12,"Antisocial","distance",2,4,1,5,2,-3,-3,-2,3,2
"265","35",2,"Antisocial","lights",2,4,3,5,6,-1,1,-2,3,1
"266","35",4,"Prosocial","homeless",11,9,9,3,3,0,0,2,3,1
"267","35",5,"Prosocial","washands",8,6,6,1,5,0,4,2,3,1
"268","35",6,"Prosocial","queue",11,9,10,5,7,1,2,2,3,1
"269","35",7,"Antisocial","coughelbow",4,6,5,4,1,-1,-3,-2,3,1
"270","35",10,"Prosocial","recycle",8,6,6,4,3,0,-1,2,3,1
"271","35",11,"Antisocial","chargers",4,6,6,7,7,0,0,-2,3,1
"272","35",12,"Antisocial","shower",4,6,6,7,7,0,0,-2,3,1
"273","36",2,"Antisocial","coughelbow",3,5,2,2,1,-3,-1,-2,4,2
"274","36",4,"Prosocial","sustainable",11,9,6,4,5,-3,1,2,4,2
"275","36",5,"Prosocial","homeless",11,9,6,2,4,-3,2,2,4,2
"276","36",6,"Antisocial","meat",6,8,7,7,6,-1,-1,-2,4,2
"277","36",8,"Antisocial","chargers",6,8,6,7,4,-2,-3,-2,4,2
"278","36",9,"Antisocial","shower",4,6,6,6,4,0,-2,-2,4,2
"279","36",10,"Prosocial","washands",11,9,11,6,7,2,1,2,4,2
"280","36",12,"Prosocial","organicVegetables",8,6,6,3,1,0,-2,2,4,2
"281","37",1,"Antisocial","distance",4,6,2,7,4,-4,-3,-2,4,1
"282","37",2,"Prosocial","washands",10,8,8,5,4,0,-1,2,4,1
"283","37",3,"Prosocial","vegetarian",11,9,6,6,5,-3,-1,2,4,1
"284","37",4,"Antisocial","gathering",4,6,8,5,5,2,0,-2,4,1
"285","37",5,"Prosocial","queue",6,4,8,6,6,4,0,2,4,1
"286","37",6,"Antisocial","chargers",4,6,8,7,7,2,0,-2,4,1
"287","37",7,"Antisocial","shower",4,6,6,2,5,0,3,-2,4,1
"288","37",11,"Prosocial","bike",11,9,10,1,1,1,0,2,4,1
"289","38",1,"Antisocial","late",2,4,3,2,2,-1,0,-2,6,1
"290","38",2,"Antisocial","shower",1,3,4,2,2,1,0,-2,6,1
"291","38",3,"Prosocial","queue",8,6,7,2,2,1,0,2,6,1
"292","38",5,"Antisocial","garbage",3,5,3,3,2,-2,-1,-2,6,1
"293","38",6,"Prosocial","screentime",10,8,7,2,2,-1,0,2,6,1
"294","38",9,"Antisocial","distance",3,5,3,6,1,-2,-5,-2,6,1
"295","38",10,"Prosocial","charity",10,8,11,4,7,3,3,2,6,1
"296","38",12,"Prosocial","homeless",8,6,8,2,2,2,0,2,6,1
"297","39",1,"Prosocial","lendMoney",3,1,6,3,2,5,-1,2,3,2
"298","39",2,"Antisocial","lights",4,6,10,5,4,4,-1,-2,3,2
"299","39",6,"Antisocial","redlights",3,5,3,5,3,-2,-2,-2,3,2
"300","39",8,"Antisocial","gathering",5,7,5,5,4,-2,-1,-2,3,2
"301","39",9,"Prosocial","bike",7,5,11,1,1,6,0,2,3,2
"302","39",10,"Antisocial","chargers",9,11,9,7,7,-2,0,-2,3,2
"303","39",11,"Prosocial","vegetarian",10,8,11,4,4,3,0,2,3,2
"304","39",12,"Prosocial","volunteer",10,8,11,5,7,3,2,2,3,2
"305","40",2,"Prosocial","washands",11,9,11,5,7,2,2,2,3,2
"306","40",4,"Antisocial","distance",4,6,2,3,4,-4,1,-2,3,2
"307","40",5,"Antisocial","meat",8,10,10,7,7,0,0,-2,3,2
"308","40",6,"Prosocial","vegetarian",10,8,11,5,5,3,0,2,3,2
"309","40",7,"Prosocial","sustainable",11,9,8,4,4,-1,0,2,3,2
"310","40",8,"Antisocial","shower",4,6,6,7,6,0,-1,-2,3,2
"311","40",9,"Prosocial","volunteer",11,9,11,1,4,2,3,2,3,2
"312","40",10,"Antisocial","lights",2,4,1,3,1,-3,-2,-2,3,2
"313","41",2,"Prosocial","vaccination",8,6,1,1,1,-5,0,2,2,1
"314","41",3,"Antisocial","download",3,6,10,6,7,4,1,-3,2,1
"315","41",4,"Prosocial","facemask",8,6,4,1,1,-2,0,2,2,1
"316","41",5,"Antisocial","distance",4,6,9,7,6,3,-1,-2,2,1
"317","41",6,"Antisocial","chargers",4,6,6,7,7,0,0,-2,2,1
"318","41",9,"Prosocial","screentime",10,8,1,6,1,-7,-5,2,2,1
"319","41",10,"Antisocial","gathering",4,6,9,7,7,3,0,-2,2,1
"320","41",11,"Prosocial","queue",8,6,7,5,5,1,0,2,2,1
"321","42",1,"Antisocial","alcoholWork",4,6,7,7,5,1,-2,-2,7,1
"322","42",2,"Antisocial","late",2,4,6,2,1,2,-1,-2,7,1
"323","42",4,"Antisocial","coughelbow",2,4,5,4,1,1,-3,-2,7,1
"324","42",5,"Prosocial","crossroad",10,8,4,2,2,-4,0,2,7,1
"325","42",6,"Prosocial","screentime",8,6,4,2,5,-2,3,2,7,1
"326","42",8,"Antisocial","distance",1,3,6,5,3,3,-2,-2,7,1
"327","42",9,"Prosocial","seatBus",10,8,6,2,2,-2,0,2,7,1
"328","42",11,"Prosocial","homeless",8,6,6,1,1,0,0,2,7,1
"329","43",1,"Prosocial","volunteer",10,8,10,5,7,2,2,2,5,1
"330","43",2,"Antisocial","shower",4,6,4,6,4,-2,-2,-2,5,1
"331","43",4,"Antisocial","chargers",4,6,6,7,6,0,-1,-2,5,1
"332","43",6,"Antisocial","heating",4,6,5,4,1,-1,-3,-2,5,1
"333","43",7,"Prosocial","speed",11,9,11,6,6,2,0,2,5,1
"334","43",9,"Prosocial","bike",9,7,10,1,1,3,0,2,5,1
"335","43",10,"Antisocial","distance",9,11,11,6,7,0,1,-2,5,1
"336","43",12,"Prosocial","screentime",7,5,6,1,3,1,2,2,5,1
"337","44",1,"Prosocial","bike",6,1,11,1,1,10,0,5,1,1
"338","44",4,"Prosocial","screentime",5,1,11,1,1,10,0,4,1,1
"339","44",5,"Antisocial","late",6,11,8,7,5,-3,-2,-5,1,1
"340","44",6,"Prosocial","volunteer",8,6,4,1,1,-2,0,2,1,1
"341","44",11,"Antisocial","meat",8,10,7,7,3,-3,-4,-2,1,1
"342","44",12,"Prosocial","lendMoney",3,1,1,1,1,0,0,2,1,1
"343","45",1,"Prosocial","sustainable",9,7,6,5,4,-1,-1,2,4,1
"344","45",2,"Prosocial","volunteer",8,6,8,5,5,2,0,2,4,1
"345","45",5,"Antisocial","late",1,3,1,3,2,-2,-1,-2,4,1
"346","45",6,"Prosocial","seatBus",7,5,6,4,3,1,-1,2,4,1
"347","45",7,"Prosocial","queue",8,6,6,4,2,0,-2,2,4,1
"348","45",8,"Antisocial","shower",1,3,1,3,1,-2,-2,-2,4,1
"349","45",9,"Antisocial","alcoholWork",1,3,1,4,2,-2,-2,-2,4,1
"350","45",12,"Antisocial","meat",7,9,6,5,7,-3,2,-2,4,1
"351","46",1,"Antisocial","lights",4,6,6,5,5,0,0,-2,3,1
"352","46",2,"Prosocial","queue",8,6,8,4,6,2,2,2,3,1
"353","46",3,"Antisocial","gathering",3,5,2,3,2,-3,-1,-2,3,1
"354","46",4,"Prosocial","speed",10,8,10,3,6,2,3,2,3,1
"355","46",6,"Prosocial","lendMoney",9,7,6,4,4,-1,0,2,3,1
"356","46",9,"Antisocial","distance",3,5,2,5,2,-3,-3,-2,3,1
"357","46",10,"Prosocial","homeless",10,8,7,6,5,-1,-1,2,3,1
"358","46",12,"Antisocial","shower",5,7,6,5,4,-1,-1,-2,3,1
"359","47",1,"Antisocial","noisedisturbance",4,6,4,4,3,-2,-1,-2,3,2
"360","47",6,"Antisocial","distance",9,11,11,7,7,0,0,-2,3,2
"361","47",7,"Prosocial","queue",9,7,9,1,6,2,5,2,3,2
"362","47",8,"Antisocial","heating",4,6,2,4,2,-4,-2,-2,3,2
"363","47",9,"Prosocial","vaccination",7,5,3,1,2,-2,1,2,3,2
"364","47",10,"Antisocial","meat",9,11,9,6,6,-2,0,-2,3,2
"365","47",11,"Prosocial","vegetarian",11,9,11,1,6,2,5,2,3,2
"366","48",1,"Prosocial","bike",8,6,10,1,1,4,0,2,3,1
"367","48",2,"Antisocial","lights",4,6,4,6,4,-2,-2,-2,3,1
"368","48",3,"Antisocial","shower",4,6,6,3,2,0,-1,-2,3,1
"369","48",8,"Prosocial","sustainable",8,6,7,3,4,1,1,2,3,1
"370","48",9,"Antisocial","chargers",4,6,6,7,7,0,0,-2,3,1
"371","48",10,"Antisocial","meat",9,11,11,7,7,0,0,-2,3,1
"372","48",11,"Prosocial","ownbag",8,6,6,1,1,0,0,2,3,1
"373","48",12,"Prosocial","lendMoney",11,9,11,2,4,2,2,2,3,1
"374","49",2,"Antisocial","meat",8,10,9,7,6,-1,-1,-2,2,2
"375","49",3,"Prosocial","homeless",8,6,6,5,4,0,-1,2,2,2
"376","49",5,"Prosocial","queue",8,6,8,5,4,2,-1,2,2,2
"377","49",6,"Prosocial","screentime",8,6,8,5,6,2,1,2,2,2
"378","49",8,"Antisocial","shower",4,6,6,6,4,0,-2,-2,2,2
"379","49",10,"Antisocial","distance",6,9,5,4,3,-4,-1,-3,2,2
"380","49",11,"Prosocial","vegetarian",8,6,6,1,3,0,2,2,2,2
"381","49",12,"Antisocial","chargers",4,6,7,7,5,1,-2,-2,2,2
"382","50",1,"Antisocial","shower",3,5,4,3,2,-1,-1,-2,6,1
"383","50",4,"Prosocial","vegetarian",10,8,9,6,5,1,-1,2,6,1
"384","50",5,"Antisocial","alcoholWork",3,5,3,2,2,-2,0,-2,6,1
"385","50",6,"Antisocial","distance",4,6,5,3,3,-1,0,-2,6,1
"386","50",9,"Prosocial","speed",8,6,7,5,5,1,0,2,6,1
"387","50",10,"Antisocial","lights",4,6,4,5,7,-2,2,-2,6,1
"388","50",11,"Prosocial","volunteer",11,9,11,3,1,2,-2,2,6,1
"389","50",12,"Prosocial","queue",11,9,10,3,2,1,-1,2,6,1
"390","51",1,"Antisocial","lights",3,5,5,4,2,0,-2,-2,4,2
"391","51",2,"Prosocial","sustainable",9,7,7,1,5,0,4,2,4,2
"392","51",3,"Prosocial","lendMoney",9,7,7,1,5,0,4,2,4,2
"393","51",6,"Antisocial","shower",3,5,5,5,5,0,0,-2,4,2
"394","51",7,"Prosocial","ownbag",10,8,8,1,5,0,4,2,4,2
"395","51",9,"Antisocial","late",3,5,5,5,5,0,0,-2,4,2
"396","51",10,"Antisocial","gathering",3,5,5,4,5,0,1,-2,4,2
"397","51",11,"Prosocial","speed",9,7,6,5,3,-1,-2,2,4,2
"398","52",1,"Antisocial","chargers",5,7,5,6,4,-2,-2,-2,6,2
"399","52",3,"Antisocial","shower",1,3,1,1,1,-2,0,-2,6,2
"400","52",5,"Antisocial","meat",9,11,10,7,7,-1,0,-2,6,2
"401","52",7,"Prosocial","lendMoney",8,6,7,2,3,1,1,2,6,2
"402","52",8,"Prosocial","speed",9,7,10,6,6,3,0,2,6,2
"403","52",9,"Prosocial","queue",9,7,10,5,5,3,0,2,6,2
"404","52",11,"Antisocial","gathering",5,7,6,4,4,-1,0,-2,6,2
"405","52",12,"Prosocial","vegetarian",8,6,8,4,3,2,-1,2,6,2
"406","53",1,"Prosocial","homeless",10,8,9,6,6,1,0,2,3,2
"407","53",2,"Antisocial","coughelbow",4,6,8,4,6,2,2,-2,3,2
"408","53",3,"Prosocial","speed",11,9,8,4,5,-1,1,2,3,2
"409","53",4,"Antisocial","taxes",4,6,4,3,3,-2,0,-2,3,2
"410","53",5,"Antisocial","distance",8,10,5,2,4,-5,2,-2,3,2
"411","53",7,"Antisocial","gathering",4,6,6,6,4,0,-2,-2,3,2
"412","53",8,"Prosocial","screentime",8,6,6,6,4,0,-2,2,3,2
"413","53",10,"Prosocial","facemask",6,4,7,4,4,3,0,2,3,2
"414","54",1,"Prosocial","vegetarian",11,9,10,6,5,1,-1,2,6,1
"415","54",3,"Prosocial","organicVegetables",11,9,8,4,5,-1,1,2,6,1
"416","54",6,"Prosocial","screentime",8,6,6,3,4,0,1,2,6,1
"417","54",7,"Antisocial","meat",6,8,6,7,6,-2,-1,-2,6,1
"418","54",8,"Antisocial","chargers",4,6,6,6,6,0,0,-2,6,1
"419","54",9,"Antisocial","distance",9,11,11,7,7,0,0,-2,6,1
"420","54",12,"Prosocial","lendMoney",8,6,6,1,4,0,3,2,6,1
"421","55",2,"Antisocial","chargers",4,6,7,7,7,1,0,-2,3,1
"422","55",3,"Antisocial","late",1,3,1,5,1,-2,-4,-2,3,1
"423","55",4,"Prosocial","queue",11,9,8,5,5,-1,0,2,3,1
"424","55",6,"Antisocial","meat",9,11,11,7,7,0,0,-2,3,1
"425","55",7,"Prosocial","washands",8,6,11,2,7,5,5,2,3,1
"426","55",9,"Antisocial","coughelbow",2,4,3,6,1,-1,-5,-2,3,1
"427","55",10,"Prosocial","speed",10,8,9,2,6,1,4,2,3,1
"428","55",12,"Prosocial","lendMoney",5,3,3,1,1,0,0,2,3,1
"429","56",2,"Prosocial","speed",11,9,8,6,4,-1,-2,2,6,1
"430","56",3,"Prosocial","vegetarian",9,7,4,6,3,-3,-3,2,6,1
"431","56",4,"Prosocial","volunteer",8,6,5,1,5,-1,4,2,6,1
"432","56",5,"Antisocial","meat",8,10,7,7,5,-3,-2,-2,6,1
"433","56",7,"Antisocial","distance",6,8,7,7,5,-1,-2,-2,6,1
"434","56",9,"Prosocial","queue",7,5,9,4,4,4,0,2,6,1
"435","57",1,"Prosocial","screentime",8,6,7,4,5,1,1,2,4,1
"436","57",2,"Antisocial","late",1,2,1,1,1,-1,0,-1,4,1
"437","57",3,"Prosocial","lendMoney",3,1,1,1,1,0,0,2,4,1
"438","57",4,"Prosocial","crossroad",10,8,10,4,6,2,2,2,4,1
"439","57",8,"Antisocial","shower",4,6,6,4,1,0,-3,-2,4,1
"440","57",9,"Prosocial","seatBus",11,9,8,4,1,-1,-3,2,4,1
"441","57",11,"Antisocial","chargers",4,6,6,7,7,0,0,-2,4,1
"442","58",3,"Prosocial","homeless",10,8,6,2,2,-2,0,2,4,1
"443","58",6,"Antisocial","meat",7,9,9,7,7,0,0,-2,4,1
"444","58",7,"Prosocial","screentime",8,6,6,1,2,0,1,2,4,1
"445","58",8,"Antisocial","shower",2,4,6,3,4,2,1,-2,4,1
"446","58",9,"Antisocial","download",8,10,10,2,5,0,3,-2,4,1
"447","58",10,"Antisocial","chargers",4,6,6,5,6,0,1,-2,4,1
"448","58",11,"Prosocial","charity",10,8,11,5,6,3,1,2,4,1
"449","58",12,"Prosocial","lendMoney",8,6,6,3,4,0,1,2,4,1
"450","59",1,"Prosocial","lendMoney",8,6,6,4,3,0,-1,2,4,1
"451","59",2,"Antisocial","lights",4,6,3,2,1,-3,-1,-2,4,1
"452","59",4,"Prosocial","bike",8,6,6,1,1,0,0,2,4,1
"453","59",5,"Antisocial","noisedisturbance",2,4,2,2,1,-2,-1,-2,4,1
"454","59",8,"Antisocial","chargers",4,6,6,4,5,0,1,-2,4,1
"455","59",9,"Prosocial","speed",8,6,6,3,4,0,1,2,4,1
"456","59",11,"Prosocial","homeless",10,8,9,4,3,1,-1,2,4,1
"457","59",12,"Antisocial","meat",8,10,8,7,6,-2,-1,-2,4,1
"458","60",1,"Antisocial","gathering",3,5,4,4,2,-1,-2,-2,4,1
"459","60",3,"Prosocial","speed",10,8,6,2,2,-2,0,2,4,1
"460","60",4,"Antisocial","noisedisturbance",3,5,3,4,2,-2,-2,-2,4,1
"461","60",8,"Prosocial","screentime",8,6,6,4,6,0,2,2,4,1
"462","60",9,"Antisocial","alcoholWork",4,6,4,5,1,-2,-4,-2,4,1
"463","60",10,"Antisocial","chargers",1,3,5,5,7,2,2,-2,4,1
"464","60",11,"Prosocial","homeless",9,7,7,4,4,0,0,2,4,1
"465","60",12,"Prosocial","lendMoney",8,6,6,3,5,0,2,2,4,1
"466","61",3,"Prosocial","screentime",8,6,6,1,2,0,1,2,6,2
"467","61",5,"Antisocial","gathering",4,6,4,7,3,-2,-4,-2,6,2
"468","61",6,"Antisocial","distance",4,6,6,6,4,0,-2,-2,6,2
"469","61",7,"Antisocial","shower",1,3,3,3,3,0,0,-2,6,2
"470","61",8,"Prosocial","queue",10,8,11,5,7,3,2,2,6,2
"471","61",9,"Prosocial","homeless",9,7,8,3,5,1,2,2,6,2
"472","61",10,"Prosocial","vaccination",10,8,11,6,7,3,1,2,6,2
"473","61",12,"Antisocial","chargers",4,6,4,7,5,-2,-2,-2,6,2
"474","62",1,"Antisocial","alcoholWork",6,8,7,2,5,-1,3,-2,2,1
"475","62",2,"Prosocial","seatBus",9,7,7,3,5,0,2,2,2,1
"476","62",4,"Prosocial","ownbag",9,7,8,6,7,1,1,2,2,1
"477","62",6,"Prosocial","homeless",7,5,3,2,1,-2,-1,2,2,1
"478","62",7,"Antisocial","travelticket",3,5,2,3,1,-3,-2,-2,2,1
"479","62",9,"Prosocial","lendMoney",6,4,3,4,1,-1,-3,2,2,1
"480","62",10,"Antisocial","late",1,3,2,3,2,-1,-1,-2,2,1
"481","62",12,"Antisocial","heating",3,5,3,2,1,-2,-1,-2,2,1
"482","63",1,"Antisocial","lights",4,6,4,6,3,-2,-3,-2,3,2
"483","63",3,"Prosocial","organicVegetables",8,6,8,5,4,2,-1,2,3,2
"484","63",4,"Prosocial","vegetarian",8,6,9,1,4,3,3,2,3,2
"485","63",5,"Prosocial","speed",8,6,9,4,4,3,0,2,3,2
"486","63",7,"Antisocial","distance",2,4,2,7,2,-2,-5,-2,3,2
"487","63",9,"Prosocial","queue",8,6,6,4,4,0,0,2,3,2
"488","63",10,"Antisocial","shower",4,6,4,2,3,-2,1,-2,3,2
"489","63",11,"Antisocial","chargers",1,4,6,7,7,2,0,-3,3,2
"490","64",1,"Antisocial","lights",3,5,6,3,4,1,1,-2,3,1
"491","64",2,"Prosocial","speed",8,6,6,4,1,0,-3,2,3,1
"492","64",4,"Prosocial","homeless",11,9,7,4,5,-2,1,2,3,1
"493","64",6,"Antisocial","chargers",4,6,6,7,7,0,0,-2,3,1
"494","64",8,"Prosocial","bike",8,6,6,1,1,0,0,2,3,1
"495","64",9,"Prosocial","queue",10,8,8,4,7,0,3,2,3,1
"496","64",11,"Antisocial","heating",4,6,6,2,5,0,3,-2,3,1
"497","64",12,"Antisocial","redlights",2,4,3,4,3,-1,-1,-2,3,1
"498","65",1,"Antisocial","chargers",6,9,8,7,7,-1,0,-3,2,1
"499","65",2,"Prosocial","facemask",9,7,9,3,5,2,2,2,2,1
"500","65",5,"Antisocial","shower",1,3,6,3,2,3,-1,-2,2,1
"501","65",7,"Prosocial","organicVegetables",9,7,7,1,1,0,0,2,2,1
"502","65",8,"Antisocial","meat",9,11,11,7,7,0,0,-2,2,1
"503","65",10,"Prosocial","speed",10,8,9,3,3,1,0,2,2,1
"504","65",11,"Prosocial","homeless",9,7,5,2,2,-2,0,2,2,1
"505","65",12,"Antisocial","distance",8,10,8,4,6,-2,2,-2,2,1
"506","66",1,"Prosocial","homeless",7,5,4,2,2,-1,0,2,3,2
"507","66",2,"Antisocial","shower",4,6,3,3,5,-3,2,-2,3,2
"508","66",4,"Antisocial","gathering",4,6,6,4,6,0,2,-2,3,2
"509","66",5,"Antisocial","alcoholWork",4,6,3,2,5,-3,3,-2,3,2
"510","66",6,"Prosocial","facemask",10,8,9,2,2,1,0,2,3,2
"511","66",7,"Prosocial","sustainable",10,8,10,3,5,2,2,2,3,2
"512","66",8,"Antisocial","late",2,4,2,2,3,-2,1,-2,3,2
"513","66",12,"Prosocial","bike",9,7,10,1,3,3,2,2,3,2
"514","67",3,"Prosocial","facemask",8,6,1,1,2,-5,1,2,3,2
"515","67",5,"Prosocial","volunteer",8,6,7,1,1,1,0,2,3,2
"516","67",6,"Antisocial","garbage",2,4,2,2,3,-2,1,-2,3,2
"517","67",8,"Antisocial","chargers",4,6,6,5,3,0,-2,-2,3,2
"518","67",9,"Prosocial","lendMoney",8,6,6,1,1,0,0,2,3,2
"519","67",10,"Prosocial","speed",10,8,5,3,5,-3,2,2,3,2
"520","67",11,"Antisocial","late",1,3,6,3,5,3,2,-2,3,2
"521","67",12,"Antisocial","gathering",4,6,11,6,4,5,-2,-2,3,2
"522","68",2,"Antisocial","chargers",6,8,8,7,6,0,-1,-2,6,1
"523","68",3,"Antisocial","shower",2,4,4,2,2,0,0,-2,6,1
"524","68",4,"Prosocial","charity",11,9,11,5,7,2,2,2,6,1
"525","68",6,"Antisocial","distance",3,5,4,4,2,-1,-2,-2,6,1
"526","68",7,"Prosocial","vegetarian",10,8,9,1,6,1,5,2,6,1
"527","68",8,"Antisocial","gathering",4,6,4,3,2,-2,-1,-2,6,1
"528","68",10,"Prosocial","queue",10,8,10,3,7,2,4,2,6,1
"529","68",11,"Prosocial","vaccination",10,8,11,6,6,3,0,2,6,1
"530","69",3,"Prosocial","lendMoney",5,3,9,3,1,6,-2,2,3,1
"531","69",4,"Prosocial","facemask",8,6,6,1,1,0,0,2,3,1
"532","69",5,"Prosocial","washands",11,9,11,6,7,2,1,2,3,1
"533","69",6,"Prosocial","bike",8,6,7,1,1,1,0,2,3,1
"534","69",8,"Antisocial","lights",5,7,8,6,7,1,1,-2,3,1
"535","69",9,"Antisocial","chargers",6,8,9,7,7,1,0,-2,3,1
"536","69",11,"Antisocial","meat",9,11,11,7,7,0,0,-2,3,1
"537","69",12,"Antisocial","gathering",7,9,9,5,7,0,2,-2,3,1
"538","70",1,"Prosocial","screentime",8,6,6,2,7,0,5,2,4,1
"539","70",2,"Antisocial","lights",6,8,2,4,1,-6,-3,-2,4,1
"540","70",3,"Prosocial","recycle",11,9,10,5,4,1,-1,2,4,1
"541","70",5,"Prosocial","lendMoney",8,6,6,1,4,0,3,2,4,1
"542","70",6,"Antisocial","shower",4,6,8,2,6,2,4,-2,4,1
"543","70",7,"Antisocial","noisedisturbance",1,3,1,2,1,-2,-1,-2,4,1
"544","70",11,"Prosocial","sustainable",9,7,7,2,4,0,2,2,4,1
"545","70",12,"Antisocial","heating",4,6,6,2,4,0,2,-2,4,1
"546","71",1,"Antisocial","lights",1,3,3,2,1,0,-1,-2,5,1
"547","71",3,"Antisocial","chargers",4,6,4,6,7,-2,1,-2,5,1
"548","71",4,"Prosocial","speed",11,9,10,6,6,1,0,2,5,1
"549","71",5,"Prosocial","vegetarian",10,8,8,4,4,0,0,2,5,1
"550","71",6,"Antisocial","shower",4,6,4,3,3,-2,0,-2,5,1
"551","71",8,"Prosocial","homeless",11,9,10,3,4,1,1,2,5,1
"552","71",10,"Prosocial","screentime",9,7,6,2,4,-1,2,2,5,1
"553","71",12,"Antisocial","noisedisturbance",2,4,3,2,2,-1,0,-2,5,1
"554","72",2,"Prosocial","homeless",10,8,5,5,4,-3,-1,2,2,1
"555","72",3,"Prosocial","seatBus",11,9,1,5,1,-8,-4,2,2,1
"556","72",4,"Antisocial","redlights",3,5,3,2,3,-2,1,-2,2,1
"557","72",6,"Prosocial","speed",10,8,9,5,7,1,2,2,2,1
"558","72",7,"Antisocial","distance",4,6,5,3,5,-1,2,-2,2,1
"559","72",8,"Antisocial","late",2,4,4,3,4,0,1,-2,2,1
"560","72",9,"Antisocial","meat",9,11,11,7,7,0,0,-2,2,1
"561","72",10,"Prosocial","queue",8,6,3,4,1,-3,-3,2,2,1
"562","73",2,"Antisocial","meat",6,8,8,7,6,0,-1,-2,1,2
"563","73",4,"Prosocial","volunteer",11,9,11,2,7,2,5,2,1,2
"564","73",6,"Antisocial","chargers",4,6,6,7,6,0,-1,-2,1,2
"565","73",7,"Prosocial","queue",10,8,11,6,6,3,0,2,1,2
"566","73",8,"Prosocial","screentime",8,6,10,4,6,4,2,2,1,2
"567","73",9,"Prosocial","lendMoney",8,6,6,3,1,0,-2,2,1,2
"568","73",10,"Antisocial","distance",9,11,11,2,7,0,5,-2,1,2
"569","73",12,"Antisocial","late",2,4,1,4,1,-3,-3,-2,1,2
"570","74",3,"Antisocial","gathering",1,2,2,1,1,0,0,-1,4,1
"571","74",6,"Antisocial","noisedisturbance",1,3,4,2,5,1,3,-2,4,1
"572","74",7,"Antisocial","lights",2,4,2,5,5,-2,0,-2,4,1
"573","74",8,"Prosocial","queue",10,8,10,5,6,2,1,2,4,1
"574","74",10,"Prosocial","screentime",11,9,10,1,3,1,2,2,4,1
"575","74",11,"Antisocial","shower",3,5,3,2,4,-2,2,-2,4,1
"576","74",12,"Prosocial","speed",8,6,6,2,1,0,-1,2,4,1
"577","75",3,"Antisocial","redlights",3,5,2,2,2,-3,0,-2,5,2
"578","75",4,"Antisocial","noisedisturbance",3,5,4,2,3,-1,1,-2,5,2
"579","75",5,"Antisocial","shower",3,5,2,4,2,-3,-2,-2,5,2
"580","75",6,"Prosocial","organicVegetables",10,8,7,5,4,-1,-1,2,5,2
"581","75",7,"Prosocial","homeless",10,8,6,5,5,-2,0,2,5,2
"582","75",9,"Prosocial","vegetarian",8,6,6,2,4,0,2,2,5,2
"583","75",11,"Antisocial","gathering",4,6,3,3,3,-3,0,-2,5,2
"584","75",12,"Prosocial","washands",10,8,10,5,7,2,2,2,5,2
"585","76",1,"Antisocial","taxes",1,3,2,2,2,-1,0,-2,5,1
"586","76",2,"Prosocial","organicVegetables",10,8,9,6,6,1,0,2,5,1
"587","76",3,"Prosocial","homeless",8,6,5,2,2,-1,0,2,5,1
"588","76",7,"Prosocial","speed",8,6,6,2,4,0,2,2,5,1
"589","76",8,"Antisocial","travelticket",2,4,4,2,2,0,0,-2,5,1
"590","76",9,"Antisocial","redlights",1,3,1,2,1,-2,-1,-2,5,1
"591","76",10,"Antisocial","alcoholWork",4,6,6,4,4,0,0,-2,5,1
"592","76",11,"Prosocial","volunteer",11,9,11,5,7,2,2,2,5,1
"593","77",2,"Antisocial","late",4,6,5,3,1,-1,-2,-2,5,2
"594","77",3,"Prosocial","organicVegetables",8,6,7,5,4,1,-1,2,5,2
"595","77",4,"Prosocial","queue",10,8,11,6,5,3,-1,2,5,2
"596","77",6,"Antisocial","gathering",4,6,5,4,2,-1,-2,-2,5,2
"597","77",8,"Prosocial","screentime",7,5,6,2,4,1,2,2,5,2
"598","77",9,"Antisocial","shower",4,6,7,4,5,1,1,-2,5,2
"599","77",10,"Prosocial","vegetarian",8,6,6,1,2,0,1,2,5,2
"600","77",12,"Antisocial","meat",9,11,6,7,7,-5,0,-2,5,2
"601","78",1,"Antisocial","coughelbow",2,4,1,2,1,-3,-1,-2,4,1
"602","78",2,"Antisocial","distance",1,3,1,4,3,-2,-1,-2,4,1
"603","78",3,"Prosocial","speed",8,6,8,5,5,2,0,2,4,1
"604","78",4,"Prosocial","organicVegetables",11,9,11,6,7,2,1,2,4,1
"605","78",6,"Prosocial","queue",7,5,6,2,4,1,2,2,4,1
"606","78",7,"Prosocial","screentime",8,6,8,6,5,2,-1,2,4,1
"607","78",9,"Antisocial","chargers",4,6,5,7,5,-1,-2,-2,4,1
"608","78",10,"Antisocial","shower",4,6,5,3,2,-1,-1,-2,4,1
"609","79",1,"Prosocial","speed",10,8,5,3,3,-3,0,2,3,2
"610","79",3,"Prosocial","charity",11,9,11,5,7,2,2,2,3,2
"611","79",4,"Antisocial","late",2,4,3,4,6,-1,2,-2,3,2
"612","79",6,"Antisocial","heating",3,5,3,2,1,-2,-1,-2,3,2
"613","79",7,"Antisocial","alcoholWork",1,3,3,3,5,0,2,-2,3,2
"614","79",8,"Prosocial","lendMoney",5,3,3,1,2,0,1,2,3,2
"615","79",10,"Antisocial","noisedisturbance",3,5,2,5,3,-3,-2,-2,3,2
"616","79",11,"Prosocial","seatBus",10,8,10,3,5,2,2,2,3,2
"617","80",1,"Antisocial","gathering",3,5,5,2,3,0,1,-2,5,1
"618","80",3,"Prosocial","sustainable",6,4,5,1,4,1,3,2,5,1
"619","80",4,"Antisocial","meat",7,9,10,7,6,1,-1,-2,5,1
"620","80",7,"Prosocial","recycle",11,9,9,6,7,0,1,2,5,1
"621","80",8,"Prosocial","homeless",9,7,4,2,3,-3,1,2,5,1
"622","80",9,"Prosocial","queue",9,7,6,5,4,-1,-1,2,5,1
"623","80",10,"Antisocial","coughelbow",1,3,2,2,2,-1,0,-2,5,1
"624","80",12,"Antisocial","shower",5,7,3,3,2,-4,-1,-2,5,1
"625","81",1,"Prosocial","homeless",11,9,5,5,2,-4,-3,2,1,1
"626","81",2,"Antisocial","meat",9,11,10,7,7,-1,0,-2,1,1
"627","81",3,"Prosocial","queue",10,8,10,5,6,2,1,2,1,1
"628","81",6,"Antisocial","chargers",1,5,10,7,7,5,0,-4,1,1
"629","81",7,"Antisocial","lights",2,4,6,7,7,2,0,-2,1,1
"630","81",8,"Prosocial","screentime",11,9,1,1,1,-8,0,2,1,1
"631","81",9,"Antisocial","distance",9,11,5,2,1,-6,-1,-2,1,1
"632","81",11,"Prosocial","ownbag",10,8,9,1,2,1,1,2,1,1
"633","82",1,"Prosocial","homeless",10,8,10,4,6,2,2,2,4,2
"634","82",2,"Antisocial","garbage",1,3,2,2,1,-1,-1,-2,4,2
"635","82",5,"Antisocial","redlights",1,3,2,3,2,-1,-1,-2,4,2
"636","82",6,"Antisocial","chargers",4,6,5,5,4,-1,-1,-2,4,2
"637","82",9,"Prosocial","volunteer",8,6,8,4,4,2,0,2,4,2
"638","82",10,"Prosocial","speed",10,8,9,5,5,1,0,2,4,2
"639","82",11,"Antisocial","distance",3,5,2,6,2,-3,-4,-2,4,2
"640","82",12,"Prosocial","queue",11,9,11,5,5,2,0,2,4,2
"641","83",2,"Antisocial","download",4,6,8,6,6,2,0,-2,4,2
"642","83",4,"Prosocial","recycle",11,9,9,6,6,0,0,2,4,2
"643","83",6,"Prosocial","ownbag",10,8,9,6,6,1,0,2,4,2
"644","83",7,"Prosocial","speed",11,9,11,6,6,2,0,2,4,2
"645","83",8,"Antisocial","distance",6,8,9,6,6,1,0,-2,4,2
"646","83",9,"Antisocial","chargers",5,7,9,6,6,2,0,-2,4,2
"647","83",10,"Prosocial","volunteer",11,9,8,3,4,-1,1,2,4,2
"648","83",11,"Antisocial","alcoholWork",1,3,1,3,1,-2,-2,-2,4,2
"649","84",2,"Antisocial","shower",2,4,2,2,1,-2,-1,-2,5,1
"650","84",3,"Prosocial","vegetarian",11,9,6,4,7,-3,3,2,5,1
"651","84",6,"Antisocial","lights",1,3,1,6,1,-2,-5,-2,5,1
"652","84",7,"Antisocial","redlights",1,3,1,2,1,-2,-1,-2,5,1
"653","84",8,"Prosocial","sustainable",11,9,5,6,3,-4,-3,2,5,1
"654","84",10,"Antisocial","distance",6,8,8,5,1,0,-4,-2,5,1
"655","84",11,"Prosocial","volunteer",11,9,9,2,6,0,4,2,5,1
"656","85",1,"Antisocial","heating",3,5,3,5,1,-2,-4,-2,2,2
"657","85",2,"Prosocial","lendMoney",8,6,7,1,3,1,2,2,2,2
"658","85",3,"Prosocial","homeless",9,7,10,1,1,3,0,2,2,2
"659","85",4,"Prosocial","queue",9,7,8,1,2,1,1,2,2,2
"660","85",5,"Prosocial","speed",9,7,7,1,1,0,0,2,2,2
"661","85",8,"Antisocial","chargers",4,6,4,7,7,-2,0,-2,2,2
"662","85",9,"Antisocial","download",2,4,3,7,7,-1,0,-2,2,2
"663","85",12,"Antisocial","distance",8,11,11,7,7,0,0,-3,2,2
"664","86",1,"Prosocial","volunteer",10,8,6,5,5,-2,0,2,4,2
"665","86",2,"Prosocial","queue",9,7,6,5,4,-1,-1,2,4,2
"666","86",3,"Prosocial","organicVegetables",10,8,11,6,7,3,1,2,4,2
"667","86",4,"Antisocial","coughelbow",6,9,6,6,3,-3,-3,-3,4,2
"668","86",5,"Antisocial","distance",3,5,3,5,2,-2,-3,-2,4,2
"669","86",8,"Antisocial","download",2,4,11,7,7,7,0,-2,4,2
"670","86",9,"Prosocial","crossroad",10,8,11,3,7,3,4,2,4,2
"671","86",11,"Antisocial","late",4,6,6,2,2,0,0,-2,4,2
"672","87",4,"Prosocial","lendMoney",8,6,5,1,3,-1,2,2,3,1
"673","87",5,"Prosocial","homeless",8,6,6,1,4,0,3,2,3,1
"674","87",7,"Prosocial","speed",6,3,5,2,3,2,1,3,3,1
"675","87",12,"Antisocial","chargers",9,11,7,3,4,-4,1,-2,3,1
"676","88",2,"Prosocial","queue",9,7,6,4,4,-1,0,2,4,1
"677","88",3,"Antisocial","distance",4,6,6,6,7,0,1,-2,4,1
"678","88",5,"Prosocial","homeless",8,6,7,1,2,1,1,2,4,1
"679","88",6,"Antisocial","chargers",4,6,8,7,7,2,0,-2,4,1
"680","88",9,"Antisocial","gathering",4,6,8,5,6,2,1,-2,4,1
"681","88",10,"Prosocial","speed",9,7,9,1,3,2,2,2,4,1
"682","88",11,"Antisocial","meat",9,11,11,7,7,0,0,-2,4,1
"683","88",12,"Prosocial","organicVegetables",10,8,11,4,6,3,2,2,4,1
"684","89",2,"Prosocial","sustainable",7,5,6,1,2,1,1,2,5,1
"685","89",3,"Prosocial","homeless",8,6,4,1,1,-2,0,2,5,1
"686","89",4,"Prosocial","speed",7,5,9,5,4,4,-1,2,5,1
"687","89",5,"Antisocial","late",5,7,4,3,1,-3,-2,-2,5,1
"688","89",6,"Prosocial","organicVegetables",6,4,6,1,2,2,1,2,5,1
"689","89",9,"Antisocial","lights",4,6,3,4,2,-3,-2,-2,5,1
"690","89",10,"Antisocial","chargers",5,7,6,7,6,-1,-1,-2,5,1
"691","89",12,"Antisocial","meat",7,9,9,7,7,0,0,-2,5,1
"692","90",2,"Prosocial","homeless",8,6,6,1,2,0,1,2,1,2
"693","90",3,"Antisocial","shower",4,6,8,7,4,2,-3,-2,1,2
"694","90",4,"Antisocial","meat",9,11,11,7,7,0,0,-2,1,2
"695","90",7,"Prosocial","sustainable",8,6,6,1,4,0,3,2,1,2
"696","90",9,"Antisocial","lights",4,6,6,4,4,0,0,-2,1,2
"697","90",10,"Prosocial","queue",8,6,6,1,4,0,3,2,1,2
"698","90",11,"Antisocial","chargers",4,6,6,4,4,0,0,-2,1,2
"699","90",12,"Prosocial","volunteer",8,6,6,4,4,0,0,2,1,2
"700","91",1,"Antisocial","download",1,3,11,7,7,8,0,-2,1,1
"701","91",2,"Prosocial","vegetarian",8,6,11,1,2,5,1,2,1,1
"702","91",3,"Prosocial","organicVegetables",11,9,11,5,5,2,0,2,1,1
"703","91",8,"Antisocial","coughelbow",1,3,2,3,3,-1,0,-2,1,1
"704","91",9,"Antisocial","gathering",1,3,3,2,1,0,-1,-2,1,1
"705","91",10,"Prosocial","screentime",8,6,11,5,7,5,2,2,1,1
"706","91",11,"Prosocial","homeless",10,8,11,3,5,3,2,2,1,1
"707","92",1,"Prosocial","homeless",8,6,6,4,4,0,0,2,2,1
"708","92",3,"Antisocial","meat",9,11,10,7,6,-1,-1,-2,2,1
"709","92",6,"Antisocial","chargers",4,6,6,7,4,0,-3,-2,2,1
"710","92",8,"Prosocial","screentime",11,9,11,4,7,2,3,2,2,1
"711","92",9,"Antisocial","coughelbow",9,11,4,7,6,-7,-1,-2,2,1
"712","92",10,"Antisocial","heating",4,6,6,7,3,0,-4,-2,2,1
"713","92",11,"Prosocial","queue",10,8,10,4,6,2,2,2,2,1
"714","92",12,"Prosocial","lendMoney",8,6,6,3,4,0,1,2,2,1
"715","93",1,"Prosocial","volunteer",11,9,9,5,6,0,1,2,5,1
"716","93",3,"Antisocial","meat",7,9,10,7,6,1,-1,-2,5,1
"717","93",4,"Prosocial","sustainable",8,6,9,4,5,3,1,2,5,1
"718","93",5,"Prosocial","queue",8,6,7,3,5,1,2,2,5,1
"719","93",6,"Antisocial","coughelbow",6,8,7,7,5,-1,-2,-2,5,1
"720","93",7,"Prosocial","homeless",10,8,7,5,6,-1,1,2,5,1
"721","93",9,"Antisocial","lights",6,8,9,7,6,1,-1,-2,5,1
"722","93",11,"Antisocial","shower",6,8,4,5,4,-4,-1,-2,5,1
"723","94",3,"Prosocial","lendMoney",6,1,5,4,3,4,-1,5,2,1
"724","94",8,"Antisocial","distance",8,11,11,7,7,0,0,-3,2,1
"725","94",9,"Antisocial","alcoholWork",4,6,1,4,1,-5,-3,-2,2,1
"726","94",10,"Antisocial","meat",9,11,11,7,7,0,0,-2,2,1
"727","95",1,"Prosocial","recycle",10,8,11,2,5,3,3,2,6,1
"728","95",2,"Prosocial","bike",6,4,3,3,5,-1,2,2,6,1
"729","95",3,"Antisocial","lights",2,4,4,3,6,0,3,-2,6,1
"730","95",4,"Antisocial","shower",3,5,9,3,5,4,2,-2,6,1
"731","95",5,"Prosocial","ownbag",7,5,8,6,3,3,-3,2,6,1
"732","95",6,"Prosocial","sustainable",11,9,9,6,6,0,0,2,6,1
"733","95",7,"Antisocial","coughelbow",5,7,8,5,6,1,1,-2,6,1
"734","95",11,"Antisocial","gathering",1,3,10,5,3,7,-2,-2,6,1
"735","96",1,"Prosocial","facemask",8,6,6,2,4,0,2,2,4,1
"736","96",3,"Antisocial","redlights",2,4,6,3,4,2,1,-2,4,1
"737","96",4,"Antisocial","gathering",4,6,6,4,4,0,0,-2,4,1
"738","96",6,"Prosocial","volunteer",10,8,11,1,1,3,0,2,4,1
"739","96",7,"Prosocial","crossroad",10,8,10,4,5,2,1,2,4,1
"740","96",10,"Prosocial","bike",9,7,8,2,1,1,-1,2,4,1
"741","96",11,"Antisocial","chargers",4,6,2,7,4,-4,-3,-2,4,1
"742","96",12,"Antisocial","coughelbow",1,3,1,2,2,-2,0,-2,4,1
"743","97",1,"Prosocial","crossroad",11,9,11,3,7,2,4,2,4,2
"744","97",2,"Prosocial","vegetarian",9,7,9,1,3,2,2,2,4,2
"745","97",3,"Prosocial","lendMoney",9,7,7,1,5,0,4,2,4,2
"746","97",4,"Prosocial","queue",10,8,11,5,7,3,2,2,4,2
"747","97",5,"Antisocial","shower",3,5,4,3,3,-1,0,-2,4,2
"748","97",6,"Antisocial","distance",2,4,5,5,4,1,-1,-2,4,2
"749","97",8,"Antisocial","chargers",5,7,6,7,7,-1,0,-2,4,2
"750","97",10,"Antisocial","lights",2,4,2,4,3,-2,-1,-2,4,2
"751","97",11,"Antisocial","download",7,9,11,2,7,2,5,-2,4,2
"752","98",1,"Prosocial","lendMoney",8,6,6,1,4,0,3,2,2,2
"753","98",3,"Prosocial","queue",8,6,6,4,3,0,-1,2,2,2
"754","98",4,"Antisocial","download",4,6,6,7,4,0,-3,-2,2,2
"755","98",5,"Antisocial","distance",3,5,2,6,3,-3,-3,-2,2,2
"756","98",6,"Prosocial","sustainable",9,7,7,1,4,0,3,2,2,2
"757","98",8,"Prosocial","screentime",8,6,6,1,4,0,3,2,2,2
"758","98",10,"Antisocial","shower",4,6,6,7,4,0,-3,-2,2,2
"759","98",12,"Antisocial","lights",4,6,3,7,2,-3,-5,-2,2,2
"760","99",1,"Antisocial","gathering",4,6,4,5,3,-2,-2,-2,2,1
"761","99",2,"Prosocial","crossroad",11,9,10,5,7,1,2,2,2,1
"762","99",4,"Antisocial","coughelbow",4,6,4,4,3,-2,-1,-2,2,1
"763","99",5,"Prosocial","organicVegetables",10,8,8,5,5,0,0,2,2,1
"764","99",7,"Antisocial","download",3,5,4,3,3,-1,0,-2,2,1
"765","99",9,"Prosocial","sustainable",9,7,9,5,5,2,0,2,2,1
"766","99",11,"Antisocial","distance",1,3,4,5,4,1,-1,-2,2,1
"767","99",12,"Prosocial","washands",6,4,5,2,2,1,0,2,2,1
"768","100",1,"Prosocial","seatBus",9,7,9,6,6,2,0,2,3,1
"769","100",4,"Prosocial","bike",10,8,11,6,7,3,1,2,3,1
"770","100",7,"Antisocial","travelticket",1,3,1,2,1,-2,-1,-2,3,1
"771","100",8,"Prosocial","screentime",11,9,11,5,7,2,2,2,3,1
"772","100",9,"Antisocial","shower",3,5,1,3,1,-4,-2,-2,3,1
"773","100",10,"Antisocial","gathering",1,3,1,2,1,-2,-1,-2,3,1
"774","100",12,"Prosocial","charity",10,8,11,6,7,3,1,2,3,1
"775","101",1,"Antisocial","gathering",4,6,6,4,4,0,0,-2,3,1
"776","101",3,"Antisocial","distance",4,6,6,4,4,0,0,-2,3,1
"777","101",4,"Antisocial","lights",6,8,5,3,4,-3,1,-2,3,1
"778","101",6,"Prosocial","screentime",8,6,7,4,4,1,0,2,3,1
"779","101",7,"Prosocial","washands",10,8,9,3,3,1,0,2,3,1
"780","101",8,"Antisocial","download",5,7,6,4,4,-1,0,-2,3,1
"781","101",11,"Prosocial","vegetarian",7,5,6,1,2,1,1,2,3,1
"782","101",12,"Prosocial","sustainable",8,6,6,1,2,0,1,2,3,1
"783","102",1,"Antisocial","download",4,6,7,3,6,1,3,-2,3,2
"784","102",2,"Prosocial","volunteer",11,9,9,3,5,0,2,2,3,2
"785","102",4,"Prosocial","vegetarian",8,6,6,4,1,0,-3,2,3,2
"786","102",5,"Prosocial","lendMoney",8,6,8,1,5,2,4,2,3,2
"787","102",6,"Antisocial","shower",4,6,4,3,7,-2,4,-2,3,2
"788","102",9,"Prosocial","queue",8,6,5,1,4,-1,3,2,3,2
"789","102",11,"Antisocial","chargers",4,6,6,5,4,0,-1,-2,3,2
"790","103",1,"Prosocial","organicVegetables",8,6,10,5,5,4,0,2,5,1
"791","103",2,"Antisocial","shower",4,6,4,5,3,-2,-2,-2,5,1
"792","103",3,"Antisocial","meat",6,8,7,7,6,-1,-1,-2,5,1
"793","103",4,"Prosocial","speed",8,6,8,4,5,2,1,2,5,1
"794","103",8,"Antisocial","distance",3,5,2,2,2,-3,0,-2,5,1
"795","103",9,"Prosocial","seatBus",11,9,11,2,4,2,2,2,5,1
"796","103",10,"Prosocial","screentime",8,6,9,5,7,3,2,2,5,1
"797","103",11,"Antisocial","chargers",3,5,4,5,4,-1,-1,-2,5,1
"798","104",3,"Antisocial","coughelbow",9,11,11,6,7,0,1,-2,6,1
"799","104",4,"Antisocial","gathering",7,9,11,5,5,2,0,-2,6,1
"800","104",7,"Prosocial","sustainable",8,6,8,4,4,2,0,2,6,1
"801","104",8,"Prosocial","lendMoney",8,6,6,2,1,0,-1,2,6,1
"802","104",9,"Antisocial","distance",4,6,8,7,7,2,0,-2,6,1
"803","104",10,"Antisocial","heating",4,6,6,2,1,0,-1,-2,6,1
"804","104",12,"Prosocial","facemask",7,5,6,1,1,1,0,2,6,1
"805","105",2,"Antisocial","gathering",4,6,4,4,4,-2,0,-2,2,1
"806","105",3,"Prosocial","facemask",11,9,11,6,7,2,1,2,2,1
"807","105",5,"Prosocial","bike",11,9,10,1,2,1,1,2,2,1
"808","105",6,"Antisocial","late",1,3,4,3,2,1,-1,-2,2,1
"809","105",7,"Antisocial","alcoholWork",2,4,2,3,2,-2,-1,-2,2,1
"810","105",10,"Prosocial","lendMoney",8,6,7,1,4,1,3,2,2,1
"811","105",11,"Antisocial","coughelbow",1,3,3,4,4,0,0,-2,2,1
"812","105",12,"Prosocial","washands",11,9,11,4,4,2,0,2,2,1
"813","106",2,"Antisocial","coughelbow",4,6,6,5,3,0,-2,-2,6,2
"814","106",4,"Prosocial","screentime",11,9,6,5,5,-3,0,2,6,2
"815","106",7,"Prosocial","washands",6,3,6,1,1,3,0,3,6,2
"816","106",8,"Prosocial","facemask",8,6,6,1,1,0,0,2,6,2
"817","106",9,"Antisocial","chargers",1,4,5,4,3,1,-1,-3,6,2
"818","106",10,"Antisocial","meat",9,11,11,7,7,0,0,-2,6,2
"819","106",11,"Antisocial","lights",4,6,4,4,3,-2,-1,-2,6,2
"820","107",1,"Antisocial","chargers",3,5,2,3,2,-3,-1,-2,2,2
"821","107",2,"Antisocial","lights",2,4,2,4,1,-2,-3,-2,2,2
"822","107",4,"Antisocial","late",3,5,4,5,4,-1,-1,-2,2,2
"823","107",6,"Prosocial","queue",4,2,1,4,1,-1,-3,2,2,2
"824","107",7,"Prosocial","bike",10,8,10,3,3,2,0,2,2,2
"825","107",8,"Prosocial","homeless",9,7,8,3,3,1,0,2,2,2
"826","107",11,"Antisocial","shower",1,3,2,4,4,-1,0,-2,2,2
"827","107",12,"Prosocial","lendMoney",8,6,5,4,4,-1,0,2,2,2
"828","108",2,"Prosocial","organicVegetables",9,7,8,5,6,1,1,2,5,2
"829","108",4,"Antisocial","shower",2,4,2,3,2,-2,-1,-2,5,2
"830","108",5,"Antisocial","late",1,3,1,2,1,-2,-1,-2,5,2
"831","108",6,"Prosocial","recycle",11,9,10,3,5,1,2,2,5,2
"832","108",7,"Antisocial","distance",4,6,3,6,5,-3,-1,-2,5,2
"833","108",9,"Antisocial","alcoholWork",5,7,3,5,2,-4,-3,-2,5,2
"834","108",12,"Prosocial","sustainable",9,7,8,4,4,1,0,2,5,2
"835","109",1,"Prosocial","homeless",8,6,7,4,4,1,0,2,3,2
"836","109",2,"Antisocial","gathering",1,3,1,2,1,-2,-1,-2,3,2
"837","109",3,"Prosocial","organicVegetables",8,6,7,4,4,1,0,2,3,2
"838","109",4,"Antisocial","noisedisturbance",1,3,1,2,1,-2,-1,-2,3,2
"839","109",5,"Prosocial","facemask",11,9,11,6,7,2,1,2,3,2
"840","109",7,"Prosocial","screentime",8,6,9,4,6,3,2,2,3,2
"841","109",8,"Antisocial","download",1,3,2,2,2,-1,0,-2,3,2
"842","109",9,"Antisocial","chargers",4,6,6,6,4,0,-2,-2,3,2
"843","110",1,"Antisocial","shower",2,4,2,2,1,-2,-1,-2,6,1
"844","110",2,"Prosocial","queue",8,6,7,5,5,1,0,2,6,1
"845","110",3,"Prosocial","screentime",8,6,6,1,1,0,0,2,6,1
"846","110",5,"Antisocial","chargers",4,6,5,5,2,-1,-3,-2,6,1
"847","110",7,"Prosocial","volunteer",8,6,9,1,4,3,3,2,6,1
"848","110",10,"Prosocial","vegetarian",8,6,9,6,6,3,0,2,6,1
"849","110",12,"Antisocial","noisedisturbance",1,2,1,1,1,-1,0,-1,6,1
"850","111",1,"Antisocial","shower",1,3,2,4,3,-1,-1,-2,6,2
"851","111",2,"Antisocial","lights",1,3,2,2,2,-1,0,-2,6,2
"852","111",3,"Antisocial","late",2,4,2,2,2,-2,0,-2,6,2
"853","111",5,"Prosocial","seatBus",11,9,10,3,4,1,1,2,6,2
"854","111",6,"Antisocial","distance",3,5,4,5,3,-1,-2,-2,6,2
"855","111",9,"Prosocial","sustainable",11,9,11,4,6,2,2,2,6,2
"856","111",10,"Prosocial","lendMoney",8,6,6,2,2,0,0,2,6,2
"857","111",11,"Prosocial","vegetarian",10,8,11,3,4,3,1,2,6,2
"858","112",2,"Antisocial","chargers",4,6,3,4,2,-3,-2,-2,5,2
"859","112",3,"Prosocial","lendMoney",11,9,9,4,5,0,1,2,5,2
"860","112",4,"Prosocial","queue",8,6,8,5,5,2,0,2,5,2
"861","112",5,"Prosocial","homeless",8,6,6,5,4,0,-1,2,5,2
"862","112",6,"Antisocial","lights",4,6,3,4,2,-3,-2,-2,5,2
"863","112",7,"Prosocial","screentime",9,7,6,2,4,-1,2,2,5,2
"864","112",10,"Antisocial","download",4,6,6,4,4,0,0,-2,5,2
"865","112",11,"Antisocial","meat",8,10,10,7,6,0,-1,-2,5,2
"866","113",1,"Antisocial","chargers",1,3,1,7,5,-2,-2,-2,6,2
"867","113",2,"Antisocial","parking",4,6,6,5,3,0,-2,-2,6,2
"868","113",3,"Antisocial","distance",8,11,1,4,5,-10,1,-3,6,2
"869","113",4,"Prosocial","queue",6,3,6,1,4,3,3,3,6,2
"870","113",8,"Prosocial","lendMoney",8,6,8,1,2,2,1,2,6,2
"871","113",10,"Antisocial","shower",4,6,4,7,7,-2,0,-2,6,2
"872","113",11,"Prosocial","speed",8,6,11,4,7,5,3,2,6,2
"873","113",12,"Prosocial","homeless",8,6,8,2,5,2,3,2,6,2
"874","114",2,"Prosocial","volunteer",9,7,11,2,3,4,1,2,5,2
"875","114",3,"Antisocial","late",3,5,4,2,3,-1,1,-2,5,2
"876","114",4,"Antisocial","chargers",4,6,5,6,6,-1,0,-2,5,2
"877","114",6,"Prosocial","facemask",11,9,11,5,5,2,0,2,5,2
"878","114",7,"Prosocial","charity",10,8,11,6,7,3,1,2,5,2
"879","114",8,"Prosocial","bike",10,8,9,2,1,1,-1,2,5,2
"880","114",10,"Antisocial","lights",3,5,3,2,2,-2,0,-2,5,2
"881","114",11,"Antisocial","heating",4,6,6,5,5,0,0,-2,5,2
"882","115",2,"Prosocial","organicVegetables",8,6,8,4,4,2,0,2,5,2
"883","115",3,"Antisocial","alcoholWork",4,6,3,4,1,-3,-3,-2,5,2
"884","115",4,"Antisocial","meat",9,11,11,7,7,0,0,-2,5,2
"885","115",7,"Antisocial","chargers",4,6,6,7,7,0,0,-2,5,2
"886","115",9,"Antisocial","travelticket",1,6,1,1,1,-5,0,-5,5,2
"887","115",10,"Prosocial","vegetarian",8,6,8,1,4,2,3,2,5,2
"888","115",12,"Prosocial","lendMoney",9,7,6,1,1,-1,0,2,5,2
"889","116",2,"Prosocial","homeless",8,6,4,1,1,-2,0,2,6,2
"890","116",4,"Antisocial","download",1,3,2,3,3,-1,0,-2,6,2
"891","116",5,"Prosocial","bike",10,8,11,1,1,3,0,2,6,2
"892","116",6,"Prosocial","speed",9,7,11,6,6,4,0,2,6,2
"893","116",7,"Antisocial","distance",2,4,2,6,2,-2,-4,-2,6,2
"894","116",9,"Antisocial","chargers",4,6,4,7,5,-2,-2,-2,6,2
"895","116",11,"Prosocial","organicVegetables",8,6,7,1,2,1,1,2,6,2
"896","116",12,"Antisocial","lights",3,5,3,2,1,-2,-1,-2,6,2
"897","117",1,"Antisocial","garbage",1,3,1,2,1,-2,-1,-2,2,2
"898","117",3,"Prosocial","charity",10,8,7,5,3,-1,-2,2,2,2
"899","117",4,"Prosocial","crossroad",10,8,7,4,4,-1,0,2,2,2
"900","117",5,"Antisocial","alcoholWork",3,5,2,2,1,-3,-1,-2,2,2
"901","117",6,"Prosocial","sustainable",11,9,8,4,5,-1,1,2,2,2
"902","117",8,"Antisocial","shower",4,6,2,3,2,-4,-1,-2,2,2
"903","117",11,"Prosocial","washands",11,9,11,5,5,2,0,2,2,2
"904","117",12,"Antisocial","coughelbow",2,4,2,2,1,-2,-1,-2,2,2
"905","118",1,"Prosocial","organicVegetables",11,9,10,5,6,1,1,2,6,2
"906","118",4,"Prosocial","screentime",8,6,9,5,6,3,1,2,6,2
"907","118",7,"Prosocial","queue",11,9,9,5,6,0,1,2,6,2
"908","118",9,"Antisocial","meat",6,8,8,6,5,0,-1,-2,6,2
"909","118",10,"Prosocial","lendMoney",11,9,7,6,5,-2,-1,2,6,2
"910","119",1,"Prosocial","crossroad",10,8,11,1,7,3,6,2,6,2
"911","119",4,"Antisocial","chargers",9,11,11,7,7,0,0,-2,6,2
"912","119",5,"Antisocial","distance",4,6,8,5,6,2,1,-2,6,2
"913","119",6,"Antisocial","meat",9,11,11,7,7,0,0,-2,6,2
"914","119",7,"Prosocial","volunteer",9,7,11,1,1,4,0,2,6,2
"915","119",8,"Prosocial","lendMoney",11,9,11,1,2,2,1,2,6,2
"916","119",9,"Prosocial","recycle",11,9,11,5,6,2,1,2,6,2
"917","119",10,"Antisocial","gathering",6,8,10,3,6,2,3,-2,6,2
"918","120",1,"Antisocial","redlights",2,4,3,4,1,-1,-3,-2,2,1
"919","120",2,"Antisocial","gathering",1,3,7,2,5,4,3,-2,2,1
"920","120",3,"Prosocial","seatBus",6,4,8,3,7,4,4,2,2,1
"921","120",4,"Antisocial","download",5,7,11,6,7,4,1,-2,2,1
"922","120",6,"Prosocial","charity",10,8,11,2,7,3,5,2,2,1
"923","120",8,"Prosocial","crossroad",11,9,10,3,7,1,4,2,2,1
"924","120",9,"Prosocial","facemask",9,7,6,4,4,-1,0,2,2,1
"925","120",12,"Antisocial","heating",1,3,3,2,2,0,0,-2,2,1
"926","121",2,"Antisocial","download",7,10,4,2,1,-6,-1,-3,1,1
"927","121",3,"Antisocial","late",6,9,4,7,1,-5,-6,-3,1,1
"928","121",4,"Prosocial","homeless",8,6,5,2,1,-1,-1,2,1,1
"929","121",5,"Prosocial","ownbag",6,3,5,1,2,2,1,3,1,1
"930","121",6,"Antisocial","chargers",9,11,8,7,3,-3,-4,-2,1,1
"931","121",7,"Prosocial","sustainable",6,3,4,1,3,1,2,3,1,1
"932","121",8,"Prosocial","washands",6,3,1,6,6,-2,0,3,1,1
"933","121",12,"Antisocial","travelticket",6,10,5,2,1,-5,-1,-4,1,1
"934","122",3,"Prosocial","lendMoney",10,8,7,3,5,-1,2,2,4,2
"935","122",4,"Prosocial","facemask",9,7,10,4,7,3,3,2,4,2
"936","122",5,"Antisocial","distance",4,6,6,6,4,0,-2,-2,4,2
"937","122",6,"Antisocial","travelticket",2,4,2,2,4,-2,2,-2,4,2
"938","122",7,"Antisocial","shower",4,6,3,3,2,-3,-1,-2,4,2
"939","122",9,"Prosocial","vegetarian",11,10,7,5,4,-3,-1,1,4,2
"940","122",10,"Antisocial","lights",2,4,2,2,2,-2,0,-2,4,2
"941","122",12,"Prosocial","homeless",9,7,6,4,4,-1,0,2,4,2
"942","123",2,"Prosocial","crossroad",8,6,6,1,1,0,0,2,1,1
"943","123",3,"Antisocial","shower",4,6,5,7,7,-1,0,-2,1,1
"944","123",5,"Prosocial","vegetarian",8,6,6,1,1,0,0,2,1,1
"945","123",8,"Prosocial","homeless",8,6,8,1,3,2,2,2,1,1
"946","123",9,"Antisocial","lights",2,4,2,2,2,-2,0,-2,1,1
"947","123",10,"Antisocial","chargers",4,6,6,7,7,0,0,-2,1,1
"948","123",11,"Antisocial","coughelbow",4,6,6,4,4,0,0,-2,1,1
"949","123",12,"Prosocial","charity",8,6,8,1,1,2,0,2,1,1
"950","124",1,"Prosocial","lendMoney",8,6,6,4,4,0,0,2,4,1
"951","124",3,"Antisocial","redlights",1,3,1,2,1,-2,-1,-2,4,1
"952","124",5,"Prosocial","washands",7,5,3,1,2,-2,1,2,4,1
"953","124",6,"Prosocial","charity",8,6,11,2,7,5,5,2,4,1
"954","124",7,"Antisocial","shower",7,9,3,6,2,-6,-4,-2,4,1
"955","124",8,"Prosocial","vegetarian",10,8,9,6,6,1,0,2,4,1
"956","124",10,"Antisocial","meat",9,11,10,7,6,-1,-1,-2,4,1
"957","124",12,"Antisocial","chargers",8,10,6,7,4,-4,-3,-2,4,1
"958","125",1,"Prosocial","vegetarian",8,6,8,1,5,2,4,2,6,1
"959","125",2,"Antisocial","chargers",4,6,4,5,2,-2,-3,-2,6,1
"960","125",3,"Antisocial","lights",3,5,3,2,1,-2,-1,-2,6,1
"961","125",4,"Antisocial","shower",3,5,4,4,3,-1,-1,-2,6,1
"962","125",5,"Prosocial","lendMoney",9,7,8,3,5,1,2,2,6,1
"963","125",7,"Antisocial","distance",1,3,1,2,1,-2,-1,-2,6,1
"964","125",9,"Prosocial","bike",10,8,11,1,5,3,4,2,6,1
"965","125",12,"Prosocial","organicVegetables",11,9,11,4,6,2,2,2,6,1
"966","126",1,"Antisocial","noisedisturbance",4,6,4,4,1,-2,-3,-2,3,1
"967","126",3,"Antisocial","meat",9,11,11,7,7,0,0,-2,3,1
"968","126",4,"Antisocial","chargers",4,6,6,7,7,0,0,-2,3,1
"969","126",5,"Prosocial","homeless",8,6,6,4,3,0,-1,2,3,1
"970","126",9,"Prosocial","facemask",8,6,5,1,5,-1,4,2,3,1
"971","126",10,"Antisocial","gathering",6,8,9,7,1,1,-6,-2,3,1
"972","126",11,"Prosocial","lendMoney",8,6,6,4,2,0,-2,2,3,1
"973","126",12,"Prosocial","ownbag",8,6,6,4,2,0,-2,2,3,1
"974","127",1,"Prosocial","organicVegetables",8,6,2,5,4,-4,-1,2,4,2
"975","127",3,"Prosocial","volunteer",10,8,3,5,3,-5,-2,2,4,2
"976","127",5,"Prosocial","sustainable",8,6,6,3,5,0,2,2,4,2
"977","127",6,"Prosocial","speed",8,6,1,3,1,-5,-2,2,4,2
"978","127",9,"Antisocial","coughelbow",6,8,8,3,1,0,-2,-2,4,2
"979","127",10,"Antisocial","chargers",4,6,9,6,7,3,1,-2,4,2
"980","127",11,"Antisocial","heating",3,5,1,2,1,-4,-1,-2,4,2
"981","127",12,"Antisocial","noisedisturbance",2,4,7,4,2,3,-2,-2,4,2
"982","128",4,"Prosocial","bike",9,7,7,2,5,0,3,2,4,2
"983","128",5,"Prosocial","vegetarian",8,6,9,6,7,3,1,2,4,2
"984","128",6,"Antisocial","redlights",4,6,4,3,1,-2,-2,-2,4,2
"985","128",7,"Prosocial","homeless",11,9,10,3,6,1,3,2,4,2
"986","128",8,"Antisocial","chargers",5,7,5,4,4,-2,0,-2,4,2
"987","128",10,"Antisocial","gathering",3,5,6,6,4,1,-2,-2,4,2
"988","128",11,"Antisocial","lights",6,8,5,4,2,-3,-2,-2,4,2
"989","128",12,"Prosocial","facemask",9,7,10,1,5,3,4,2,4,2
"990","129",3,"Antisocial","shower",4,6,6,5,3,0,-2,-2,5,1
"991","129",4,"Antisocial","distance",7,9,7,5,5,-2,0,-2,5,1
"992","129",7,"Antisocial","gathering",3,5,7,2,4,2,2,-2,5,1
"993","129",8,"Prosocial","bike",10,8,8,1,2,0,1,2,5,1
"994","129",9,"Antisocial","chargers",4,6,8,7,6,2,-1,-2,5,1
"995","129",10,"Prosocial","organicVegetables",9,7,8,6,6,1,0,2,5,1
"996","129",12,"Prosocial","lendMoney",10,8,8,4,7,0,3,2,5,1
"997","130",2,"Prosocial","bike",11,9,11,1,2,2,1,2,4,1
"998","130",3,"Antisocial","distance",2,4,3,3,4,-1,1,-2,4,1
"999","130",5,"Prosocial","speed",11,9,10,6,7,1,1,2,4,1
"1000","130",6,"Prosocial","screentime",8,6,11,2,6,5,4,2,4,1
"1001","130",7,"Antisocial","lights",3,5,2,3,3,-3,0,-2,4,1
"1002","130",9,"Prosocial","vegetarian",11,9,10,3,3,1,0,2,4,1
"1003","130",10,"Antisocial","download",7,9,11,7,7,2,0,-2,4,1
"1004","130",12,"Antisocial","meat",7,9,10,7,7,1,0,-2,4,1
"1005","131",3,"Prosocial","speed",6,4,5,1,1,1,0,2,4,2
"1006","131",6,"Prosocial","lendMoney",8,6,6,1,4,0,3,2,4,2
"1007","131",7,"Antisocial","alcoholWork",4,6,6,5,6,0,1,-2,4,2
"1008","131",8,"Antisocial","shower",1,3,2,4,3,-1,-1,-2,4,2
"1009","131",9,"Prosocial","homeless",8,6,9,3,4,3,1,2,4,2
"1010","131",10,"Antisocial","chargers",4,6,6,7,7,0,0,-2,4,2
"1011","131",11,"Prosocial","queue",8,6,4,4,4,-2,0,2,4,2
"1012","132",1,"Prosocial","volunteer",9,7,6,5,5,-1,0,2,3,2
"1013","132",3,"Prosocial","homeless",9,7,8,4,5,1,1,2,3,2
"1014","132",5,"Prosocial","recycle",10,8,9,5,6,1,1,2,3,2
"1015","132",6,"Antisocial","noisedisturbance",3,5,4,2,3,-1,1,-2,3,2
"1016","132",7,"Antisocial","distance",3,5,3,2,3,-2,1,-2,3,2
"1017","132",9,"Antisocial","gathering",3,5,4,3,2,-1,-1,-2,3,2
"1018","132",10,"Antisocial","lights",2,4,4,4,3,0,-1,-2,3,2
"1019","132",11,"Prosocial","crossroad",10,8,10,4,6,2,2,2,3,2
"1020","133",1,"Prosocial","homeless",8,6,7,1,3,1,2,2,3,1
"1021","133",2,"Antisocial","coughelbow",2,4,1,2,1,-3,-1,-2,3,1
"1022","133",3,"Prosocial","sustainable",11,9,11,6,7,2,1,2,3,1
"1023","133",5,"Prosocial","queue",9,7,7,5,4,0,-1,2,3,1
"1024","133",7,"Antisocial","chargers",3,5,6,7,4,1,-3,-2,3,1
"1025","133",9,"Antisocial","distance",4,6,6,4,4,0,0,-2,3,1
"1026","133",10,"Antisocial","gathering",2,4,6,2,3,2,1,-2,3,1
"1027","133",11,"Prosocial","seatBus",11,9,11,4,6,2,2,2,3,1
"1028","134",1,"Antisocial","distance",2,4,6,5,4,2,-1,-2,7,2
"1029","134",2,"Prosocial","speed",8,6,6,2,5,0,3,2,7,2
"1030","134",3,"Antisocial","download",4,6,6,4,5,0,1,-2,7,2
"1031","134",4,"Prosocial","bike",10,8,11,2,7,3,5,2,7,2
"1032","134",5,"Antisocial","chargers",3,5,2,2,1,-3,-1,-2,7,2
"1033","134",6,"Prosocial","homeless",9,7,8,2,6,1,4,2,7,2
"1034","134",7,"Prosocial","organicVegetables",8,6,10,5,7,4,2,2,7,2
"1035","134",9,"Antisocial","coughelbow",9,11,11,7,7,0,0,-2,7,2
"1036","135",1,"Prosocial","organicVegetables",8,6,6,4,1,0,-3,2,1,2
"1037","135",2,"Antisocial","gathering",7,11,8,4,6,-3,2,-4,1,2
"1038","135",3,"Antisocial","taxes",4,6,6,4,4,0,0,-2,1,2
"1039","135",4,"Prosocial","facemask",3,1,1,1,1,0,0,2,1,2
"1040","135",6,"Prosocial","queue",3,1,1,1,1,0,0,2,1,2
"1041","135",10,"Antisocial","download",4,6,6,4,4,0,0,-2,1,2
"1042","135",11,"Prosocial","homeless",8,6,8,4,5,2,1,2,1,2
"1043","136",2,"Antisocial","shower",4,6,5,5,5,-1,0,-2,3,1
"1044","136",3,"Prosocial","organicVegetables",7,5,4,2,2,-1,0,2,3,1
"1045","136",4,"Antisocial","heating",3,5,6,2,2,1,0,-2,3,1
"1046","136",6,"Antisocial","chargers",4,6,6,7,7,0,0,-2,3,1
"1047","136",8,"Prosocial","homeless",8,6,6,1,1,0,0,2,3,1
"1048","136",10,"Antisocial","late",3,5,3,2,1,-2,-1,-2,3,1
"1049","136",11,"Prosocial","lendMoney",8,6,6,2,1,0,-1,2,3,1
"1050","136",12,"Prosocial","crossroad",11,9,9,3,2,0,-1,2,3,1
"1051","137",1,"Antisocial","taxes",2,4,2,3,1,-2,-2,-2,4,1
"1052","137",2,"Prosocial","lendMoney",8,6,6,2,3,0,1,2,4,1
"1053","137",5,"Prosocial","facemask",11,9,11,6,6,2,0,2,4,1
"1054","137",7,"Prosocial","homeless",11,9,11,4,4,2,0,2,4,1
"1055","137",9,"Antisocial","download",4,6,6,4,4,0,0,-2,4,1
"1056","137",10,"Prosocial","vegetarian",11,9,11,2,2,2,0,2,4,1
"1057","137",11,"Antisocial","coughelbow",1,3,2,3,3,-1,0,-2,4,1
"1058","137",12,"Antisocial","distance",3,5,4,3,4,-1,1,-2,4,1
"1059","138",2,"Antisocial","coughelbow",1,3,1,3,5,-2,2,-2,1,2
"1060","138",3,"Antisocial","shower",7,9,10,7,7,1,0,-2,1,2
"1061","138",6,"Antisocial","meat",6,8,11,7,7,3,0,-2,1,2
"1062","138",10,"Antisocial","late",4,6,6,2,6,0,4,-2,1,2
"1063","138",11,"Prosocial","speed",10,8,8,3,3,0,0,2,1,2
"1064","138",12,"Prosocial","screentime",8,6,6,1,1,0,0,2,1,2
"1065","139",1,"Antisocial","alcoholWork",3,5,5,4,2,0,-2,-2,6,2
"1066","139",3,"Prosocial","seatBus",10,8,6,2,3,-2,1,2,6,2
"1067","139",5,"Antisocial","heating",5,7,3,2,4,-4,2,-2,6,2
"1068","139",7,"Antisocial","chargers",4,6,7,7,4,1,-3,-2,6,2
"1069","139",8,"Prosocial","charity",11,9,6,2,3,-3,1,2,6,2
"1070","139",9,"Prosocial","speed",6,4,3,1,2,-1,1,2,6,2
"1071","139",11,"Prosocial","queue",7,5,3,2,2,-2,0,2,6,2
"1072","139",12,"Antisocial","gathering",4,6,6,5,4,0,-1,-2,6,2
"1073","140",1,"Prosocial","vegetarian",9,7,8,3,5,1,2,2,5,2
"1074","140",3,"Antisocial","lights",2,4,7,2,2,3,0,-2,5,2
"1075","140",4,"Antisocial","shower",7,9,10,5,6,1,1,-2,5,2
"1076","140",7,"Antisocial","distance",5,7,11,5,7,4,2,-2,5,2
"1077","140",9,"Prosocial","sustainable",8,6,6,2,2,0,0,2,5,2
"1078","140",10,"Antisocial","coughelbow",9,11,11,7,7,0,0,-2,5,2
"1079","140",11,"Prosocial","washands",11,9,9,6,5,0,-1,2,5,2
"1080","140",12,"Prosocial","volunteer",6,4,1,1,1,-3,0,2,5,2
"1081","141",1,"Antisocial","chargers",4,6,3,5,6,-3,1,-2,4,1
"1082","141",2,"Prosocial","crossroad",11,9,10,2,6,1,4,2,4,1
"1083","141",3,"Prosocial","vegetarian",10,8,7,4,4,-1,0,2,4,1
"1084","141",5,"Antisocial","download",5,7,6,4,4,-1,0,-2,4,1
"1085","141",7,"Antisocial","distance",4,6,6,4,3,0,-1,-2,4,1
"1086","141",9,"Prosocial","charity",10,8,9,2,5,1,3,2,4,1
"1087","141",10,"Prosocial","bike",8,6,6,1,3,0,2,2,4,1
"1088","141",11,"Antisocial","lights",4,6,2,3,2,-4,-1,-2,4,1
"1089","142",1,"Antisocial","download",4,6,4,4,4,-2,0,-2,2,2
"1090","142",3,"Antisocial","taxes",4,6,4,4,1,-2,-3,-2,2,2
"1091","142",4,"Prosocial","vegetarian",8,6,6,4,4,0,0,2,2,2
"1092","142",7,"Prosocial","screentime",8,6,6,4,4,0,0,2,2,2
"1093","142",8,"Antisocial","alcoholWork",4,6,6,4,4,0,0,-2,2,2
"1094","142",9,"Prosocial","volunteer",8,6,6,4,4,0,0,2,2,2
"1095","142",10,"Antisocial","chargers",9,11,6,4,4,-5,0,-2,2,2
"1096","143",2,"Antisocial","meat",7,9,9,7,6,0,-1,-2,5,1
"1097","143",3,"Prosocial","vegetarian",9,7,6,3,5,-1,2,2,5,1
"1098","143",5,"Prosocial","ownbag",10,8,7,1,3,-1,2,2,5,1
"1099","143",6,"Antisocial","shower",2,4,2,2,1,-2,-1,-2,5,1
"1100","143",8,"Antisocial","gathering",4,6,7,6,5,1,-1,-2,5,1
"1101","143",9,"Prosocial","facemask",3,1,2,1,1,1,0,2,5,1
"1102","143",10,"Antisocial","coughelbow",9,11,11,7,7,0,0,-2,5,1
"1103","143",11,"Prosocial","speed",7,5,5,1,5,0,4,2,5,1
"1104","144",2,"Antisocial","late",4,6,5,3,3,-1,0,-2,2,1
"1105","144",3,"Prosocial","crossroad",10,8,10,3,5,2,2,2,2,1
"1106","144",4,"Prosocial","volunteer",9,7,10,3,4,3,1,2,2,1
"1107","144",5,"Prosocial","lendMoney",10,8,6,1,3,-2,2,2,2,1
"1108","144",6,"Antisocial","chargers",7,9,6,7,6,-3,-1,-2,2,1
"1109","144",8,"Prosocial","washands",8,6,6,1,2,0,1,2,2,1
"1110","144",9,"Antisocial","garbage",3,5,3,2,2,-2,0,-2,2,1
"1111","144",10,"Antisocial","download",5,7,7,3,5,0,2,-2,2,1
"1112","145",1,"Prosocial","crossroad",10,8,1,1,1,-7,0,2,2,2
"1113","145",2,"Prosocial","charity",11,9,6,5,1,-3,-4,2,2,2
"1114","145",5,"Antisocial","meat",9,11,11,7,7,0,0,-2,2,2
"1115","145",6,"Antisocial","coughelbow",3,5,1,4,1,-4,-3,-2,2,2
"1116","145",8,"Antisocial","distance",4,6,11,4,7,5,3,-2,2,2
"1117","145",9,"Prosocial","queue",6,4,1,1,4,-3,3,2,2,2
"1118","145",11,"Antisocial","late",5,7,11,6,7,4,1,-2,2,2
"1119","145",12,"Prosocial","organicVegetables",11,9,6,4,4,-3,0,2,2,2
"1120","146",2,"Antisocial","chargers",6,8,8,6,6,0,0,-2,2,2
"1121","146",3,"Antisocial","shower",7,9,8,5,6,-1,1,-2,2,2
"1122","146",4,"Antisocial","lights",3,5,4,5,2,-1,-3,-2,2,2
"1123","146",5,"Prosocial","homeless",10,8,5,2,1,-3,-1,2,2,2
"1124","146",6,"Antisocial","meat",9,11,11,7,7,0,0,-2,2,2
"1125","146",8,"Prosocial","queue",10,8,6,2,4,-2,2,2,2,2
"1126","146",9,"Prosocial","lendMoney",10,8,6,5,4,-2,-1,2,2,2
"1127","146",11,"Prosocial","screentime",11,9,10,2,5,1,3,2,2,2
"1128","147",1,"Prosocial","seatBus",9,7,9,5,6,2,1,2,4,1
"1129","147",2,"Antisocial","chargers",1,3,3,3,2,0,-1,-2,4,1
"1130","147",3,"Prosocial","speed",10,8,11,5,7,3,2,2,4,1
"1131","147",5,"Antisocial","travelticket",3,5,2,3,3,-3,0,-2,4,1
"1132","147",6,"Prosocial","ownbag",10,8,10,5,7,2,2,2,4,1
"1133","147",7,"Prosocial","screentime",6,4,5,1,3,1,2,2,4,1
"1134","147",10,"Antisocial","download",3,5,3,3,3,-2,0,-2,4,1
"1135","147",11,"Antisocial","meat",6,8,7,5,5,-1,0,-2,4,1
"1136","148",1,"Antisocial","meat",9,11,11,7,7,0,0,-2,2,2
"1137","148",2,"Prosocial","screentime",8,6,5,4,4,-1,0,2,2,2
"1138","148",3,"Antisocial","shower",7,9,3,6,3,-6,-3,-2,2,2
"1139","148",7,"Prosocial","sustainable",10,8,8,6,5,0,-1,2,2,2
"1140","148",8,"Antisocial","chargers",6,8,7,5,6,-1,1,-2,2,2
"1141","148",9,"Prosocial","speed",11,9,8,6,5,-1,-1,2,2,2
"1142","148",10,"Prosocial","lendMoney",8,6,3,3,3,-3,0,2,2,2
"1143","148",11,"Antisocial","download",1,3,7,3,4,4,1,-2,2,2
"1144","149",3,"Antisocial","coughelbow",4,6,9,4,4,3,0,-2,1,2
"1145","149",4,"Antisocial","distance",8,10,1,7,1,-9,-6,-2,1,2
"1146","149",5,"Antisocial","download",7,10,1,7,2,-9,-5,-3,1,2
"1147","149",6,"Prosocial","charity",11,9,11,6,5,2,-1,2,1,2
"1148","149",7,"Antisocial","meat",9,11,11,7,7,0,0,-2,1,2
"1149","149",9,"Prosocial","volunteer",8,6,11,1,1,5,0,2,1,2
"1150","149",10,"Prosocial","homeless",11,9,11,6,4,2,-2,2,1,2
"1151","149",12,"Prosocial","sustainable",8,6,11,4,4,5,0,2,1,2
"1152","150",3,"Antisocial","parking",1,3,3,2,2,0,0,-2,2,1
"1153","150",4,"Prosocial","seatBus",8,6,8,4,3,2,-1,2,2,1
"1154","150",5,"Prosocial","queue",10,8,9,5,3,1,-2,2,2,1
"1155","150",6,"Antisocial","heating",4,6,5,2,3,-1,1,-2,2,1
"1156","150",8,"Antisocial","coughelbow",2,4,1,3,2,-3,-1,-2,2,1
"1157","150",9,"Antisocial","chargers",4,6,5,7,6,-1,-1,-2,2,1
"1158","150",10,"Prosocial","screentime",9,7,7,3,3,0,0,2,2,1
"1159","150",12,"Prosocial","recycle",11,9,11,6,6,2,0,2,2,1
"1160","151",1,"Prosocial","facemask",9,7,9,6,6,2,0,2,5,2
"1161","151",2,"Antisocial","meat",6,8,6,7,3,-2,-4,-2,5,2
"1162","151",3,"Prosocial","lendMoney",8,6,5,3,5,-1,2,2,5,2
"1163","151",5,"Antisocial","gathering",1,3,1,2,1,-2,-1,-2,5,2
"1164","151",6,"Prosocial","organicVegetables",8,6,8,3,3,2,0,2,5,2
"1165","151",7,"Prosocial","sustainable",11,9,8,2,5,-1,3,2,5,2
"1166","151",8,"Antisocial","late",4,6,2,4,4,-4,0,-2,5,2
"1167","151",9,"Antisocial","noisedisturbance",3,5,3,4,6,-2,2,-2,5,2
"1168","152",1,"Antisocial","noisedisturbance",1,3,1,1,1,-2,0,-2,5,2
"1169","152",2,"Antisocial","taxes",4,6,1,3,1,-5,-2,-2,5,2
"1170","152",4,"Prosocial","seatBus",8,6,8,3,5,2,2,2,5,2
"1171","152",7,"Prosocial","crossroad",11,9,9,4,4,0,0,2,5,2
"1172","152",11,"Prosocial","speed",9,7,6,4,4,-1,0,2,5,2
"1173","152",12,"Prosocial","vegetarian",8,6,11,4,6,5,2,2,5,2
"1174","153",2,"Antisocial","shower",3,5,5,2,4,0,2,-2,4,1
"1175","153",3,"Antisocial","coughelbow",2,4,1,2,1,-3,-1,-2,4,1
"1176","153",5,"Prosocial","screentime",8,6,7,1,4,1,3,2,4,1
"1177","153",8,"Prosocial","speed",11,9,11,6,5,2,-1,2,4,1
"1178","153",9,"Antisocial","late",2,4,3,5,3,-1,-2,-2,4,1
"1179","153",10,"Prosocial","vegetarian",11,9,10,5,7,1,2,2,4,1
"1180","153",11,"Prosocial","volunteer",11,9,11,2,5,2,3,2,4,1
"1181","153",12,"Antisocial","chargers",4,6,6,7,7,0,0,-2,4,1
"1182","154",1,"Prosocial","screentime",9,7,9,5,7,2,2,2,7,1
"1183","154",2,"Prosocial","lendMoney",7,5,5,1,2,0,1,2,7,1
"1184","154",3,"Antisocial","download",1,3,3,3,1,0,-2,-2,7,1
"1185","154",4,"Antisocial","chargers",5,7,8,7,7,1,0,-2,7,1
"1186","154",6,"Antisocial","gathering",5,7,4,5,1,-3,-4,-2,7,1
"1187","154",9,"Prosocial","facemask",10,8,9,4,7,1,3,2,7,1
"1188","154",10,"Prosocial","crossroad",10,8,11,4,3,3,-1,2,7,1
"1189","154",12,"Antisocial","garbage",3,5,3,4,5,-2,1,-2,7,1
"1190","155",1,"Prosocial","seatBus",10,8,6,4,5,-2,1,2,2,2
"1191","155",2,"Antisocial","shower",5,7,5,5,3,-2,-2,-2,2,2
"1192","155",3,"Prosocial","bike",10,8,7,1,5,-1,4,2,2,2
"1193","155",4,"Antisocial","chargers",4,6,5,5,4,-1,-1,-2,2,2
"1194","155",5,"Antisocial","travelticket",3,5,3,2,2,-2,0,-2,2,2
"1195","155",7,"Antisocial","meat",6,8,7,7,5,-1,-2,-2,2,2
"1196","155",11,"Prosocial","lendMoney",8,6,3,2,3,-3,1,2,2,2
"1197","155",12,"Prosocial","vegetarian",8,6,3,2,2,-3,0,2,2,2
"1198","156",2,"Antisocial","download",6,8,8,3,5,0,2,-2,3,2
"1199","156",4,"Prosocial","volunteer",7,5,8,3,1,3,-2,2,3,2
"1200","156",5,"Prosocial","crossroad",8,4,8,3,5,4,2,4,3,2
"1201","156",6,"Antisocial","chargers",9,11,11,7,7,0,0,-2,3,2
"1202","156",7,"Prosocial","queue",3,1,1,1,1,0,0,2,3,2
"1203","156",8,"Antisocial","meat",9,11,8,5,5,-3,0,-2,3,2
"1204","156",9,"Prosocial","homeless",11,9,11,1,1,2,0,2,3,2
"1205","156",12,"Antisocial","taxes",6,11,8,7,6,-3,-1,-5,3,2
"1206","157",1,"Antisocial","chargers",4,6,6,4,4,0,0,-2,4,2
"1207","157",3,"Prosocial","homeless",9,7,9,2,2,2,0,2,4,2
"1208","157",5,"Prosocial","ownbag",11,9,9,5,6,0,1,2,4,2
"1209","157",6,"Antisocial","download",4,6,6,2,4,0,2,-2,4,2
"1210","157",7,"Antisocial","gathering",2,4,4,3,3,0,0,-2,4,2
"1211","157",8,"Prosocial","charity",10,8,10,5,6,2,1,2,4,2
"1212","157",9,"Prosocial","screentime",8,6,9,5,3,3,-2,2,4,2
"1213","157",10,"Antisocial","distance",6,8,6,2,3,-2,1,-2,4,2
"1214","158",1,"Antisocial","heating",4,6,8,7,4,2,-3,-2,2,2
"1215","158",2,"Antisocial","distance",1,3,7,7,5,4,-2,-2,2,2
"1216","158",4,"Prosocial","bike",8,6,7,1,1,1,0,2,2,2
"1217","158",5,"Antisocial","lights",4,6,2,7,1,-4,-6,-2,2,2
"1218","158",6,"Prosocial","organicVegetables",11,9,6,4,4,-3,0,2,2,2
"1219","158",8,"Antisocial","meat",9,11,11,7,7,0,0,-2,2,2
"1220","158",9,"Prosocial","homeless",6,4,1,1,1,-3,0,2,2,2
"1221","158",11,"Prosocial","seatBus",8,6,6,1,1,0,0,2,2,2
"1222","159",2,"Prosocial","crossroad",10,8,9,4,6,1,2,2,2,1
"1223","159",3,"Prosocial","speed",11,9,8,6,3,-1,-3,2,2,1
"1224","159",6,"Antisocial","meat",7,9,11,7,7,2,0,-2,2,1
"1225","159",7,"Prosocial","queue",9,7,6,5,3,-1,-2,2,2,1
"1226","159",9,"Antisocial","distance",4,6,3,3,2,-3,-1,-2,2,1
"1227","159",10,"Antisocial","gathering",4,6,6,2,5,0,3,-2,2,1
"1228","159",11,"Antisocial","chargers",1,3,3,7,6,0,-1,-2,2,1
"1229","159",12,"Prosocial","bike",9,7,9,5,1,2,-4,2,2,1
"1230","160",2,"Prosocial","lendMoney",11,9,10,4,6,1,2,2,4,1
"1231","160",3,"Antisocial","late",1,3,2,2,2,-1,0,-2,4,1
"1232","160",4,"Antisocial","lights",1,3,1,2,1,-2,-1,-2,4,1
"1233","160",5,"Prosocial","vegetarian",9,7,11,5,7,4,2,2,4,1
"1234","160",7,"Antisocial","download",3,5,3,3,3,-2,0,-2,4,1
"1235","160",9,"Prosocial","speed",9,7,9,4,5,2,1,2,4,1
"1236","160",10,"Prosocial","screentime",8,6,6,2,4,0,2,2,4,1
"1237","160",11,"Antisocial","coughelbow",2,4,2,2,1,-2,-1,-2,4,1
"1238","161",1,"Antisocial","gathering",5,7,6,4,6,-1,2,-2,3,2
"1239","161",2,"Antisocial","chargers",7,9,7,6,7,-2,1,-2,3,2
"1240","161",4,"Prosocial","sustainable",8,6,6,4,4,0,0,2,3,2
"1241","161",6,"Prosocial","bike",9,7,9,3,4,2,1,2,3,2
"1242","161",9,"Antisocial","coughelbow",2,4,4,4,3,0,-1,-2,3,2
"1243","161",10,"Prosocial","facemask",8,6,6,2,5,0,3,2,3,2
"1244","161",11,"Antisocial","shower",8,10,8,4,4,-2,0,-2,3,2
"1245","162",1,"Antisocial","distance",3,5,6,4,6,1,2,-2,7,1
"1246","162",2,"Prosocial","seatBus",9,7,6,4,4,-1,0,2,7,1
"1247","162",3,"Antisocial","noisedisturbance",1,3,1,2,1,-2,-1,-2,7,1
"1248","162",6,"Prosocial","queue",7,5,6,3,5,1,2,2,7,1
"1249","162",7,"Prosocial","sustainable",10,8,8,4,4,0,0,2,7,1
"1250","162",9,"Antisocial","shower",3,5,4,4,3,-1,-1,-2,7,1
"1251","162",10,"Prosocial","washands",8,6,6,4,5,0,1,2,7,1
"1252","162",11,"Antisocial","lights",4,6,6,4,5,0,1,-2,7,1
"1253","163",1,"Prosocial","sustainable",8,6,9,2,4,3,2,2,5,2
"1254","163",3,"Prosocial","bike",8,6,9,1,1,3,0,2,5,2
"1255","163",4,"Antisocial","meat",9,11,11,7,7,0,0,-2,5,2
"1256","163",5,"Antisocial","chargers",7,9,10,6,7,1,1,-2,5,2
"1257","163",6,"Antisocial","shower",6,8,6,7,4,-2,-3,-2,5,2
"1258","163",8,"Prosocial","speed",8,6,6,2,2,0,0,2,5,2
"1259","163",10,"Prosocial","vegetarian",8,6,6,3,1,0,-2,2,5,2
"1260","163",12,"Antisocial","lights",1,3,1,4,1,-2,-3,-2,5,2
"1261","164",4,"Prosocial","recycle",8,3,6,1,4,3,3,5,2,2
"1262","164",5,"Prosocial","facemask",3,1,2,2,1,1,-1,2,2,2
"1263","164",6,"Antisocial","chargers",9,11,10,6,7,-1,1,-2,2,2
"1264","164",7,"Antisocial","meat",9,11,10,7,7,-1,0,-2,2,2
"1265","164",8,"Antisocial","shower",9,11,11,7,7,0,0,-2,2,2
"1266","164",10,"Prosocial","ownbag",6,1,1,1,2,0,1,5,2,2
"1267","164",11,"Prosocial","washands",6,3,2,1,6,-1,5,3,2,2
"1268","164",12,"Antisocial","heating",4,6,2,2,4,-4,2,-2,2,2
"1269","165",1,"Antisocial","shower",4,6,5,5,4,-1,-1,-2,2,1
"1270","165",3,"Prosocial","homeless",9,7,7,1,2,0,1,2,2,1
"1271","165",4,"Antisocial","meat",9,11,11,7,7,0,0,-2,2,1
"1272","165",5,"Antisocial","distance",6,8,11,4,4,3,0,-2,2,1
"1273","165",7,"Antisocial","chargers",1,3,1,1,1,-2,0,-2,2,1
"1274","165",8,"Prosocial","charity",11,9,11,5,7,2,2,2,2,1
"1275","165",10,"Antisocial","coughelbow",3,5,3,2,1,-2,-1,-2,2,1
"1276","165",11,"Prosocial","bike",8,6,6,1,1,0,0,2,2,1
"1277","165",12,"Prosocial","lendMoney",8,6,5,2,2,-1,0,2,2,1
"1278","166",1,"Antisocial","gathering",3,5,2,4,3,-3,-1,-2,4,1
"1279","166",2,"Antisocial","distance",4,6,2,3,3,-4,0,-2,4,1
"1280","166",3,"Prosocial","vegetarian",8,6,6,1,3,0,2,2,4,1
"1281","166",4,"Prosocial","lendMoney",10,8,10,6,5,2,-1,2,4,1
"1282","166",5,"Prosocial","organicVegetables",8,6,6,5,2,0,-3,2,4,1
"1283","166",7,"Antisocial","meat",9,11,11,7,7,0,0,-2,4,1
"1284","166",8,"Prosocial","screentime",8,6,9,6,6,3,0,2,4,1
"1285","166",10,"Antisocial","download",3,5,6,5,5,1,0,-2,4,1
"1286","167",2,"Antisocial","alcoholWork",5,7,4,2,4,-3,2,-2,5,2
"1287","167",3,"Prosocial","screentime",11,9,3,2,3,-6,1,2,5,2
"1288","167",5,"Prosocial","recycle",11,9,10,6,6,1,0,2,5,2
"1289","167",6,"Prosocial","charity",11,9,10,4,6,1,2,2,5,2
"1290","167",7,"Antisocial","meat",7,9,10,6,7,1,1,-2,5,2
"1291","167",10,"Antisocial","distance",3,5,4,2,3,-1,1,-2,5,2
"1292","167",11,"Antisocial","download",5,7,3,5,4,-4,-1,-2,5,2
