"","X","participant_id","trial","Treatment","Beh","SI_PN","PN_1","PN_2","IB_1","IB_2","PN_moves","IB_moves","Treatment_GN","subCloseness","order"
"1",1,1,1,"Prosocial","vegetarian",11,9,8,3,7,-1,4,2,3,2
"2",2,1,4,"Antisocial","distance",8,10,4,7,3,-6,-4,-2,3,2
"3",3,1,6,"Prosocial","speed",11,9,11,6,7,2,1,2,3,2
"4",4,1,7,"Prosocial","bike",10,8,5,2,5,-3,3,2,3,2
"5",5,1,8,"Antisocial","heating",4,6,7,3,3,1,0,-2,3,2
"6",6,1,10,"Antisocial","lights",6,8,8,5,5,0,0,-2,3,2
"7",7,1,11,"Prosocial","seatBus",8,6,9,3,5,3,2,2,3,2
"8",8,1,12,"Antisocial","chargers",4,6,7,5,4,1,-1,-2,3,2
"9",9,2,2,"Antisocial","coughelbow",2,4,3,6,5,-1,-1,-2,5,2
"10",10,2,3,"Antisocial","chargers",4,6,5,7,7,-1,0,-2,5,2
"11",11,2,9,"Antisocial","lights",6,8,6,6,7,-2,1,-2,5,2
"12",12,2,10,"Antisocial","distance",9,11,11,3,7,0,4,-2,5,2
"13",13,2,11,"Prosocial","screentime",8,6,6,3,4,0,1,2,5,2
"14",14,3,1,"Prosocial","bike",10,8,11,2,4,3,2,2,3,1
"15",15,3,3,"Antisocial","meat",8,10,10,7,7,0,0,-2,3,1
"16",16,3,4,"Prosocial","speed",8,6,9,4,5,3,1,2,3,1
"17",17,3,5,"Prosocial","vegetarian",8,6,6,1,2,0,1,2,3,1
"18",18,3,9,"Antisocial","lights",4,6,7,5,5,1,0,-2,3,1
"19",19,3,10,"Antisocial","download",5,7,8,5,5,1,0,-2,3,1
"20",20,3,11,"Antisocial","distance",1,3,1,5,2,-2,-3,-2,3,1
"21",21,3,12,"Prosocial","homeless",11,9,9,3,4,0,1,2,3,1
"22",22,4,2,"Antisocial","parking",3,5,3,5,2,-2,-3,-2,5,1
"23",23,4,3,"Antisocial","late",2,4,3,4,2,-1,-2,-2,5,1
"24",24,4,4,"Antisocial","shower",4,6,6,4,3,0,-1,-2,5,1
"25",25,4,6,"Antisocial","lights",4,6,4,4,3,-2,-1,-2,5,1
"26",26,4,7,"Prosocial","volunteer",9,7,8,4,5,1,1,2,5,1
"27",27,4,10,"Prosocial","lendMoney",9,7,9,4,5,2,1,2,5,1
"28",28,4,11,"Prosocial","sustainable",8,6,8,4,5,2,1,2,5,1
"29",29,4,12,"Prosocial","vegetarian",8,6,7,2,4,1,2,2,5,1
"30",30,5,1,"Antisocial","lights",1,3,1,2,1,-2,-1,-2,4,2
"31",31,5,2,"Prosocial","bike",6,4,2,1,2,-2,1,2,4,2
"32",32,5,4,"Prosocial","crossroad",8,6,6,4,4,0,0,2,4,2
"33",33,5,5,"Antisocial","download",4,6,6,4,4,0,0,-2,4,2
"34",34,5,6,"Prosocial","sustainable",8,6,8,4,6,2,2,2,4,2
"35",35,5,8,"Antisocial","shower",4,6,6,4,4,0,0,-2,4,2
"36",36,5,9,"Antisocial","chargers",8,10,9,7,7,-1,0,-2,4,2
"37",37,5,11,"Prosocial","volunteer",7,5,6,2,4,1,2,2,4,2
"38",38,6,1,"Antisocial","late",2,4,1,2,2,-3,0,-2,5,2
"39",39,6,2,"Antisocial","heating",2,4,2,2,4,-2,2,-2,5,2
"40",40,6,3,"Prosocial","sustainable",10,8,11,3,5,3,2,2,5,2
"41",41,6,4,"Prosocial","seatBus",6,4,9,4,3,5,-1,2,5,2
"42",42,6,6,"Prosocial","washands",11,9,10,5,5,1,0,2,5,2
"43",43,6,7,"Prosocial","bike",11,9,10,2,3,1,1,2,5,2
"44",44,6,9,"Antisocial","shower",2,4,2,2,2,-2,0,-2,5,2
"45",45,6,10,"Antisocial","chargers",7,9,5,6,7,-4,1,-2,5,2
"46",46,7,1,"Antisocial","parking",1,3,2,2,2,-1,0,-2,5,1
"47",47,7,4,"Antisocial","chargers",5,7,7,6,7,0,1,-2,5,1
"48",48,7,5,"Prosocial","vegetarian",11,9,9,2,3,0,1,2,5,1
"49",49,7,6,"Antisocial","lights",6,8,4,5,6,-4,1,-2,5,1
"50",50,7,8,"Prosocial","screentime",10,8,10,5,7,2,2,2,5,1
"51",51,7,10,"Prosocial","bike",11,9,10,2,2,1,0,2,5,1
"52",52,7,11,"Prosocial","volunteer",11,9,9,3,7,0,4,2,5,1
"53",53,7,12,"Antisocial","download",6,8,8,6,6,0,0,-2,5,1
"54",54,8,2,"Prosocial","speed",9,7,8,5,5,1,0,2,3,2
"55",55,8,3,"Antisocial","download",1,3,1,2,1,-2,-1,-2,3,2
"56",56,8,4,"Prosocial","bike",9,7,8,3,5,1,2,2,3,2
"57",57,8,5,"Antisocial","noisedisturbance",1,3,2,3,1,-1,-2,-2,3,2
"58",58,8,6,"Antisocial","chargers",1,3,2,3,2,-1,-1,-2,3,2
"59",59,8,8,"Prosocial","recycle",10,8,9,3,6,1,3,2,3,2
"60",60,8,10,"Prosocial","screentime",9,7,9,5,6,2,1,2,3,2
"61",61,8,11,"Antisocial","late",2,4,3,5,2,-1,-3,-2,3,2
"62",62,9,1,"Prosocial","lendMoney",8,6,9,2,6,3,4,2,6,1
"63",63,9,3,"Antisocial","shower",4,6,6,4,4,0,0,-2,6,1
"64",64,9,4,"Prosocial","screentime",8,6,9,2,5,3,3,2,6,1
"65",65,9,6,"Antisocial","heating",4,6,3,2,2,-3,0,-2,6,1
"66",66,9,8,"Prosocial","bike",8,6,9,4,4,3,0,2,6,1
"67",67,9,9,"Prosocial","queue",3,1,2,2,2,1,0,2,6,1
"68",68,9,10,"Antisocial","distance",9,11,11,7,7,0,0,-2,6,1
"69",69,9,11,"Antisocial","coughelbow",4,6,3,4,2,-3,-2,-2,6,1
"70",70,10,2,"Antisocial","download",4,6,1,2,1,-5,-1,-2,3,2
"71",71,10,3,"Antisocial","distance",3,5,5,3,3,0,0,-2,3,2
"72",72,10,4,"Antisocial","chargers",3,5,5,5,5,0,0,-2,3,2
"73",73,10,7,"Prosocial","lendMoney",9,7,10,2,4,3,2,2,3,2
"74",74,10,8,"Prosocial","seatBus",11,9,9,3,7,0,4,2,3,2
"75",75,10,9,"Prosocial","recycle",10,8,9,5,6,1,1,2,3,2
"76",76,10,10,"Prosocial","screentime",9,7,6,2,2,-1,0,2,3,2
"77",77,10,11,"Antisocial","shower",2,4,1,6,1,-3,-5,-2,3,2
"78",78,11,1,"Antisocial","distance",8,10,4,7,3,-6,-4,-2,5,2
"79",79,11,2,"Prosocial","seatBus",11,9,11,4,5,2,1,2,5,2
"80",80,11,5,"Antisocial","late",4,6,5,4,4,-1,0,-2,5,2
"81",81,11,7,"Prosocial","vegetarian",10,8,11,2,2,3,0,2,5,2
"82",82,11,8,"Prosocial","queue",11,9,11,5,5,2,0,2,5,2
"83",83,11,9,"Antisocial","chargers",4,6,5,6,5,-1,-1,-2,5,2
"84",84,11,10,"Prosocial","sustainable",11,9,11,3,5,2,2,2,5,2
"85",85,11,11,"Antisocial","shower",2,4,2,4,4,-2,0,-2,5,2
"86",86,12,2,"Antisocial","alcoholWork",3,5,2,2,2,-3,0,-2,7,1
"87",87,12,4,"Prosocial","queue",5,3,1,1,1,-2,0,2,7,1
"88",88,12,6,"Antisocial","travelticket",6,8,4,2,3,-4,1,-2,7,1
"89",89,12,7,"Antisocial","shower",7,9,9,6,7,0,1,-2,7,1
"90",90,12,9,"Prosocial","homeless",9,7,9,6,6,2,0,2,7,1
"91",91,12,10,"Antisocial","distance",1,3,1,2,1,-2,-1,-2,7,1
"92",92,12,11,"Prosocial","sustainable",7,5,9,3,5,4,2,2,7,1
"93",93,12,12,"Prosocial","volunteer",9,7,7,5,6,0,1,2,7,1
"94",94,13,1,"Antisocial","chargers",8,10,11,7,7,1,0,-2,4,1
"95",95,13,2,"Antisocial","meat",9,11,11,7,7,0,0,-2,4,1
"96",96,13,4,"Prosocial","speed",6,4,6,2,4,2,2,2,4,1
"97",97,13,6,"Prosocial","screentime",9,7,9,5,4,2,-1,2,4,1
"98",98,13,8,"Antisocial","download",5,7,8,7,6,1,-1,-2,4,1
"99",99,13,10,"Antisocial","alcoholWork",1,6,1,1,1,-5,0,-5,4,1
"100",100,13,11,"Prosocial","queue",8,6,4,1,1,-2,0,2,4,1
"101",101,13,12,"Prosocial","vegetarian",8,6,8,1,1,2,0,2,4,1
"102",102,14,1,"Prosocial","homeless",10,8,9,2,2,1,0,2,6,2
"103",103,14,2,"Antisocial","chargers",4,6,5,2,6,-1,4,-2,6,2
"104",104,14,3,"Prosocial","speed",7,5,7,2,7,2,5,2,6,2
"105",105,14,6,"Prosocial","sustainable",11,9,11,2,2,2,0,2,6,2
"106",106,14,7,"Antisocial","distance",8,10,10,2,7,0,5,-2,6,2
"107",107,14,10,"Prosocial","lendMoney",8,6,6,1,5,0,4,2,6,2
"108",108,14,11,"Antisocial","download",4,6,6,3,6,0,3,-2,6,2
"109",109,15,3,"Antisocial","coughelbow",4,6,4,4,2,-2,-2,-2,6,1
"110",110,15,4,"Antisocial","distance",9,11,11,7,7,0,0,-2,6,1
"111",111,15,5,"Prosocial","bike",11,9,10,4,6,1,2,2,6,1
"112",112,15,7,"Antisocial","noisedisturbance",1,3,1,2,1,-2,-1,-2,6,1
"113",113,15,8,"Antisocial","shower",4,6,4,3,3,-2,0,-2,6,1
"114",114,15,10,"Prosocial","seatBus",10,8,11,5,7,3,2,2,6,1
"115",115,15,11,"Prosocial","vegetarian",8,6,11,5,6,5,1,2,6,1
"116",116,15,12,"Prosocial","queue",4,2,3,1,2,1,1,2,6,1
"117",117,16,2,"Antisocial","heating",4,6,3,3,2,-3,-1,-2,2,2
"118",118,16,3,"Antisocial","alcoholWork",4,6,4,2,2,-2,0,-2,2,2
"119",119,16,4,"Prosocial","seatBus",10,8,11,3,4,3,1,2,2,2
"120",120,16,6,"Prosocial","queue",9,7,9,2,5,2,3,2,2,2
"121",121,16,7,"Antisocial","gathering",7,9,7,7,5,-2,-2,-2,2,2
"122",122,16,9,"Prosocial","vegetarian",7,5,4,1,1,-1,0,2,2,2
"123",123,16,10,"Antisocial","chargers",4,6,8,7,7,2,0,-2,2,2
"124",124,16,12,"Prosocial","charity",11,9,11,2,7,2,5,2,2,2
"125",125,17,1,"Antisocial","distance",2,4,2,2,1,-2,-1,-2,3,1
"126",126,17,2,"Prosocial","recycle",11,9,11,5,7,2,2,2,3,1
"127",127,17,3,"Antisocial","alcoholWork",1,2,1,1,1,-1,0,-1,3,1
"128",128,17,4,"Prosocial","bike",10,8,9,1,3,1,2,2,3,1
"129",129,17,5,"Antisocial","chargers",4,6,6,7,6,0,-1,-2,3,1
"130",130,17,9,"Antisocial","shower",4,6,5,6,5,-1,-1,-2,3,1
"131",131,17,11,"Prosocial","charity",10,8,11,1,4,3,3,2,3,1
"132",132,17,12,"Prosocial","organicVegetables",9,7,8,2,4,1,2,2,3,1
"133",133,18,1,"Prosocial","queue",8,6,6,3,5,0,2,2,3,2
"134",134,18,2,"Antisocial","shower",4,6,2,4,1,-4,-3,-2,3,2
"135",135,18,3,"Antisocial","taxes",1,3,1,2,1,-2,-1,-2,3,2
"136",136,18,5,"Antisocial","meat",6,8,9,7,7,1,0,-2,3,2
"137",137,18,7,"Prosocial","vegetarian",10,8,8,6,3,0,-3,2,3,2
"138",138,18,8,"Antisocial","late",2,4,2,4,1,-2,-3,-2,3,2
"139",139,18,11,"Prosocial","crossroad",8,6,8,1,2,2,1,2,3,2
"140",140,18,12,"Prosocial","volunteer",10,8,9,2,2,1,0,2,3,2
"141",141,19,1,"Antisocial","late",3,5,4,2,2,-1,0,-2,4,2
"142",142,19,2,"Prosocial","lendMoney",9,7,7,1,5,0,4,2,4,2
"143",143,19,5,"Prosocial","queue",9,7,7,4,5,0,1,2,4,2
"144",144,19,7,"Antisocial","download",4,6,5,4,4,-1,0,-2,4,2
"145",145,19,8,"Antisocial","distance",9,11,10,6,6,-1,0,-2,4,2
"146",146,19,10,"Prosocial","homeless",10,8,8,2,4,0,2,2,4,2
"147",147,19,11,"Antisocial","chargers",7,9,6,7,5,-3,-2,-2,4,2
"148",148,19,12,"Prosocial","screentime",10,8,7,1,3,-1,2,2,4,2
"149",149,20,2,"Prosocial","organicVegetables",8,6,7,3,4,1,1,2,6,1
"150",150,20,4,"Antisocial","distance",2,4,1,7,1,-3,-6,-2,6,1
"151",151,20,5,"Antisocial","shower",6,8,7,6,4,-1,-2,-2,6,1
"152",152,20,6,"Prosocial","crossroad",11,9,9,5,6,0,1,2,6,1
"153",153,20,9,"Prosocial","charity",10,8,11,6,7,3,1,2,6,1
"154",154,20,10,"Antisocial","chargers",7,9,6,6,4,-3,-2,-2,6,1
"155",155,20,11,"Antisocial","heating",4,6,6,3,4,0,1,-2,6,1
"156",156,20,12,"Prosocial","seatBus",11,9,11,6,5,2,-1,2,6,1
"157",157,21,1,"Antisocial","distance",1,3,1,2,2,-2,0,-2,2,1
"158",158,21,2,"Antisocial","download",3,5,6,5,5,1,0,-2,2,1
"159",159,21,4,"Antisocial","chargers",2,4,5,6,6,1,0,-2,2,1
"160",160,21,5,"Prosocial","homeless",9,7,6,1,2,-1,1,2,2,1
"161",161,21,6,"Prosocial","washands",10,8,8,5,5,0,0,2,2,1
"162",162,21,9,"Prosocial","ownbag",9,7,6,4,4,-1,0,2,2,1
"163",163,21,10,"Prosocial","speed",10,8,6,5,4,-2,-1,2,2,1
"164",164,21,12,"Antisocial","coughelbow",3,5,5,2,3,0,1,-2,2,1
"165",165,22,1,"Antisocial","coughelbow",2,4,3,3,2,-1,-1,-2,4,1
"166",166,22,3,"Prosocial","speed",8,6,9,3,5,3,2,2,4,1
"167",167,22,6,"Prosocial","volunteer",8,6,9,2,4,3,2,2,4,1
"168",168,22,7,"Antisocial","chargers",4,6,4,7,3,-2,-4,-2,4,1
"169",169,22,8,"Prosocial","ownbag",10,8,11,6,7,3,1,2,4,1
"170",170,22,10,"Antisocial","download",4,6,4,3,4,-2,1,-2,4,1
"171",171,22,11,"Antisocial","distance",3,5,3,3,2,-2,-1,-2,4,1
"173",173,23,1,"Prosocial","organicVegetables",9,7,7,1,1,0,0,2,1,2
"174",174,23,2,"Antisocial","coughelbow",6,8,11,5,1,3,-4,-2,1,2
"175",175,23,6,"Antisocial","lights",4,6,2,2,1,-4,-1,-2,1,2
"176",176,23,8,"Prosocial","vegetarian",7,5,1,1,4,-4,3,2,1,2
"177",177,23,9,"Prosocial","sustainable",9,7,7,4,4,0,0,2,1,2
"178",178,23,10,"Prosocial","washands",11,9,11,4,2,2,-2,2,1,2
"179",179,23,11,"Antisocial","cyberbully",3,5,2,2,1,-3,-1,-2,1,2
"180",180,23,12,"Antisocial","shower",2,4,3,5,3,-1,-2,-2,1,2
"181",181,24,2,"Antisocial","lights",3,5,5,4,4,0,0,-2,6,2
"182",182,24,4,"Antisocial","distance",4,6,5,7,6,-1,-1,-2,6,2
"183",183,24,5,"Prosocial","screentime",8,6,8,2,2,2,0,2,6,2
"184",184,24,6,"Prosocial","volunteer",10,8,11,1,2,3,1,2,6,2
"185",185,24,7,"Prosocial","organicVegetables",9,7,8,2,3,1,1,2,6,2
"186",186,24,8,"Antisocial","gathering",3,5,2,3,3,-3,0,-2,6,2
"187",187,24,10,"Prosocial","bike",11,9,11,1,4,2,3,2,6,2
"188",188,24,12,"Antisocial","chargers",4,6,6,7,7,0,0,-2,6,2
"189",189,25,1,"Antisocial","download",1,4,4,4,6,0,2,-3,5,2
"190",190,25,2,"Prosocial","organicVegetables",11,9,10,6,6,1,0,2,5,2
"191",191,25,3,"Antisocial","gathering",1,2,1,1,1,-1,0,-1,5,2
"192",192,25,5,"Prosocial","vegetarian",9,7,10,4,2,3,-2,2,5,2
"193",193,25,8,"Antisocial","lights",1,3,1,1,2,-2,1,-2,5,2
"194",194,25,9,"Prosocial","speed",10,8,11,5,5,3,0,2,5,2
"195",195,25,10,"Prosocial","bike",8,6,9,4,2,3,-2,2,5,2
"196",196,25,11,"Antisocial","redlights",2,4,3,2,1,-1,-1,-2,5,2
"197",197,26,2,"Prosocial","organicVegetables",9,7,6,3,6,-1,3,2,5,2
"198",198,26,3,"Antisocial","coughelbow",2,4,1,2,4,-3,2,-2,5,2
"199",199,26,5,"Prosocial","ownbag",9,7,7,4,5,0,1,2,5,2
"200",200,26,6,"Prosocial","speed",8,6,7,4,5,1,1,2,5,2
"201",201,26,7,"Prosocial","queue",8,6,6,4,5,0,1,2,5,2
"202",202,26,8,"Antisocial","gathering",6,8,7,5,5,-1,0,-2,5,2
"203",203,26,9,"Antisocial","shower",4,6,6,5,5,0,0,-2,5,2
"204",204,26,12,"Antisocial","chargers",4,6,7,7,5,1,-2,-2,5,2
"205",205,27,1,"Antisocial","download",1,3,7,5,7,4,2,-2,4,1
"206",206,27,2,"Antisocial","lights",4,6,8,5,6,2,1,-2,4,1
"207",207,27,3,"Prosocial","homeless",10,8,8,4,3,0,-1,2,4,1
"208",208,27,4,"Prosocial","queue",9,7,4,5,2,-3,-3,2,4,1
"209",209,27,7,"Prosocial","bike",9,7,11,1,1,4,0,2,4,1
"210",210,27,10,"Prosocial","vegetarian",6,4,7,1,2,3,1,2,4,1
"211",211,27,11,"Antisocial","meat",8,10,10,7,7,0,0,-2,4,1
"212",212,27,12,"Antisocial","chargers",1,3,2,6,6,-1,0,-2,4,1
"213",213,28,1,"Prosocial","organicVegetables",8,6,5,4,3,-1,-1,2,5,2
"214",214,28,4,"Prosocial","bike",8,6,6,1,4,0,3,2,5,2
"215",215,28,5,"Antisocial","distance",2,4,3,6,3,-1,-3,-2,5,2
"217",217,28,8,"Antisocial","meat",6,8,11,7,7,3,0,-2,5,2
"218",218,28,9,"Antisocial","gathering",4,6,4,2,5,-2,3,-2,5,2
"219",219,28,10,"Antisocial","chargers",7,9,11,7,6,2,-1,-2,5,2
"220",220,28,12,"Prosocial","homeless",11,9,9,4,6,0,2,2,5,2
"221",221,29,1,"Antisocial","heating",3,5,5,4,4,0,0,-2,2,1
"222",222,29,4,"Antisocial","shower",4,6,8,7,4,2,-3,-2,2,1
"223",223,29,5,"Prosocial","sustainable",9,7,9,4,4,2,0,2,2,1
"224",224,29,8,"Prosocial","charity",10,8,9,2,5,1,3,2,2,1
"225",225,29,9,"Antisocial","lights",3,5,8,5,5,3,0,-2,2,1
"226",226,29,10,"Prosocial","homeless",9,7,11,1,3,4,2,2,2,1
"227",227,29,11,"Antisocial","chargers",3,5,7,7,6,2,-1,-2,2,1
"228",228,29,12,"Prosocial","vegetarian",8,6,5,1,3,-1,2,2,2,1
"229",229,30,1,"Antisocial","heating",4,6,5,2,1,-1,-1,-2,3,1
"230",230,30,3,"Antisocial","redlights",1,3,1,2,1,-2,-1,-2,3,1
"231",231,30,4,"Antisocial","lights",3,5,5,4,1,0,-3,-2,3,1
"232",232,30,5,"Prosocial","queue",10,8,9,4,5,1,1,2,3,1
"233",233,30,6,"Prosocial","homeless",11,9,11,4,6,2,2,2,3,1
"234",234,30,10,"Prosocial","volunteer",11,9,11,3,4,2,1,2,3,1
"235",235,30,11,"Prosocial","charity",11,9,11,4,5,2,1,2,3,1
"236",236,30,12,"Antisocial","parking",2,4,2,2,1,-2,-1,-2,3,1
"237",237,31,1,"Prosocial","speed",8,6,7,4,4,1,0,2,6,1
"238",238,31,2,"Prosocial","bike",11,9,11,1,1,2,0,2,6,1
"239",239,31,3,"Antisocial","shower",4,6,4,7,6,-2,-1,-2,6,1
"240",240,31,5,"Antisocial","lights",6,8,5,5,6,-3,1,-2,6,1
"241",241,31,6,"Prosocial","crossroad",10,8,11,2,2,3,0,2,6,1
"242",242,31,10,"Antisocial","download",4,6,6,4,5,0,1,-2,6,1
"243",243,31,11,"Antisocial","chargers",6,8,6,7,7,-2,0,-2,6,1
"244",244,31,12,"Prosocial","screentime",8,6,4,1,2,-2,1,2,6,1
"245",245,32,1,"Antisocial","lights",4,6,6,6,6,0,0,-2,3,1
"246",246,32,2,"Prosocial","organicVegetables",6,4,4,1,2,0,1,2,3,1
"247",247,32,4,"Prosocial","speed",8,6,8,1,2,2,1,2,3,1
"248",248,32,7,"Antisocial","cyberbully",4,6,5,5,3,-1,-2,-2,3,1
"249",249,32,9,"Prosocial","homeless",8,6,6,1,1,0,0,2,3,1
"250",250,32,10,"Prosocial","vegetarian",7,5,4,1,1,-1,0,2,3,1
"251",251,32,11,"Antisocial","chargers",4,6,6,7,6,0,-1,-2,3,1
"252",252,32,12,"Antisocial","distance",4,6,6,6,4,0,-2,-2,3,1
"253",253,33,1,"Antisocial","meat",8,10,10,7,6,0,-1,-2,3,2
"254",254,33,4,"Antisocial","travelticket",4,6,6,3,1,0,-2,-2,3,2
"255",255,33,6,"Prosocial","organicVegetables",11,9,9,5,6,0,1,2,3,2
"256",256,33,7,"Prosocial","homeless",7,5,8,5,5,3,0,2,3,2
"257",257,33,9,"Antisocial","distance",1,3,1,5,1,-2,-4,-2,3,2
"258",258,33,10,"Prosocial","queue",5,3,2,3,2,-1,-1,2,3,2
"259",259,33,11,"Antisocial","shower",8,10,8,7,6,-2,-1,-2,3,2
"260",260,33,12,"Prosocial","volunteer",11,9,7,3,6,-2,3,2,3,2
"261",261,34,2,"Antisocial","chargers",1,3,6,4,4,3,0,-2,1,1
"262",262,34,3,"Prosocial","ownbag",8,6,6,4,4,0,0,2,1,1
"263",263,34,5,"Antisocial","gathering",2,4,1,5,1,-3,-4,-2,1,1
"264",264,34,7,"Prosocial","bike",9,7,6,3,4,-1,1,2,1,1
"265",265,34,8,"Antisocial","download",4,6,6,4,4,0,0,-2,1,1
"266",266,34,10,"Prosocial","queue",6,4,6,5,4,2,-1,2,1,1
"267",267,34,11,"Prosocial","screentime",8,6,6,4,4,0,0,2,1,1
"268",268,34,12,"Antisocial","travelticket",4,6,6,4,4,0,0,-2,1,1
"269",269,35,7,"Prosocial","homeless",8,6,9,4,5,3,1,2,3,1
"270",270,35,8,"Prosocial","speed",7,5,6,2,5,1,3,2,3,1
"271",271,35,10,"Prosocial","queue",8,6,8,5,6,2,1,2,3,1
"272",272,35,12,"Prosocial","vegetarian",9,7,9,2,6,2,4,2,3,1
"273",273,36,1,"Antisocial","heating",1,3,1,1,1,-2,0,-2,2,2
"274",274,36,3,"Prosocial","lendMoney",8,6,7,2,3,1,1,2,2,2
"275",275,36,4,"Antisocial","distance",1,3,1,7,3,-2,-4,-2,2,2
"276",276,36,6,"Prosocial","queue",8,6,7,2,5,1,3,2,2,2
"277",277,36,7,"Antisocial","gathering",3,5,3,2,2,-2,0,-2,2,2
"278",278,36,9,"Prosocial","screentime",10,8,10,2,4,2,2,2,2,2
"279",279,36,10,"Prosocial","organicVegetables",9,7,6,1,3,-1,2,2,2,2
"280",280,36,11,"Antisocial","meat",6,8,6,7,7,-2,0,-2,2,2
"281",281,36,12,"Antisocial","chargers",4,6,4,6,4,-2,-2,-2,2,2
"282",282,37,2,"Prosocial","bike",11,9,9,1,4,0,3,2,4,1
"283",283,37,3,"Antisocial","cyberbully",2,4,2,2,1,-2,-1,-2,4,1
"284",284,37,4,"Antisocial","chargers",2,4,1,5,2,-3,-3,-2,4,1
"285",285,37,6,"Antisocial","download",4,6,6,4,4,0,0,-2,4,1
"286",286,37,7,"Antisocial","distance",8,10,11,7,7,1,0,-2,4,1
"287",287,37,9,"Prosocial","homeless",8,6,6,1,4,0,3,2,4,1
"288",288,37,10,"Prosocial","charity",11,9,10,1,5,1,4,2,4,1
"289",289,37,11,"Prosocial","vegetarian",6,4,6,1,4,2,3,2,4,1
"290",290,38,1,"Prosocial","vegetarian",9,7,9,3,4,2,1,2,3,1
"291",291,38,3,"Prosocial","homeless",10,8,9,2,5,1,3,2,3,1
"292",292,38,4,"Prosocial","volunteer",10,8,10,5,6,2,1,2,3,1
"293",293,38,5,"Prosocial","recycle",10,8,11,4,7,3,3,2,3,1
"294",294,38,6,"Antisocial","shower",2,4,2,2,2,-2,0,-2,3,1
"295",295,38,7,"Antisocial","download",3,5,3,4,3,-2,-1,-2,3,1
"296",296,38,9,"Antisocial","late",2,4,2,5,2,-2,-3,-2,3,1
"297",297,38,10,"Antisocial","coughelbow",6,8,3,4,2,-5,-2,-2,3,1
"298",298,39,1,"Prosocial","volunteer",11,9,11,5,6,2,1,2,6,2
"299",299,39,2,"Prosocial","queue",4,2,6,2,2,4,0,2,6,2
"301",301,39,5,"Prosocial","charity",11,9,11,6,7,2,1,2,6,2
"302",302,39,6,"Antisocial","shower",3,5,2,3,2,-3,-1,-2,6,2
"303",303,39,7,"Antisocial","heating",4,6,1,2,1,-5,-1,-2,6,2
"304",304,39,11,"Antisocial","chargers",4,6,2,6,5,-4,-1,-2,6,2
"305",305,39,12,"Antisocial","late",1,3,3,2,1,0,-1,-2,6,2
"307",307,40,2,"Antisocial","shower",6,8,5,7,7,-3,0,-2,4,1
"308",308,40,5,"Antisocial","download",3,5,4,2,2,-1,0,-2,4,1
"309",309,40,7,"Antisocial","chargers",4,6,7,7,6,1,-1,-2,4,1
"310",310,40,8,"Antisocial","redlights",1,2,1,1,1,-1,0,-1,4,1
"311",311,40,9,"Prosocial","screentime",10,8,9,3,6,1,3,2,4,1
"312",312,40,11,"Prosocial","bike",11,9,10,2,4,1,2,2,4,1
"313",313,40,12,"Prosocial","organicVegetables",11,9,9,6,7,0,1,2,4,1
"314",314,41,1,"Prosocial","seatBus",10,8,5,5,6,-3,1,2,4,2
"315",315,41,2,"Prosocial","queue",9,7,9,4,5,2,1,2,4,2
"316",316,41,4,"Antisocial","meat",6,8,11,7,7,3,0,-2,4,2
"317",317,41,5,"Prosocial","speed",10,8,7,6,4,-1,-2,2,4,2
"318",318,41,6,"Antisocial","travelticket",6,8,8,2,1,0,-1,-2,4,2
"319",319,41,7,"Antisocial","cyberbully",2,4,6,5,3,2,-2,-2,4,2
"320",320,41,9,"Antisocial","chargers",9,11,9,7,5,-2,-2,-2,4,2
"321",321,41,10,"Prosocial","bike",10,8,7,1,1,-1,0,2,4,2
"322",322,42,1,"Antisocial","noisedisturbance",2,4,3,2,1,-1,-1,-2,2,1
"323",323,42,2,"Prosocial","screentime",8,6,6,2,2,0,0,2,2,1
"324",324,42,4,"Antisocial","download",4,6,6,3,3,0,0,-2,2,1
"325",325,42,5,"Antisocial","lights",3,5,4,2,1,-1,-1,-2,2,1
"326",326,42,7,"Prosocial","homeless",10,8,11,1,1,3,0,2,2,1
"327",327,42,8,"Prosocial","charity",10,8,11,1,1,3,0,2,2,1
"328",328,42,9,"Antisocial","distance",3,5,5,4,3,0,-1,-2,2,1
"329",329,42,11,"Prosocial","crossroad",11,9,11,1,1,2,0,2,2,1
"330",330,43,1,"Antisocial","download",8,10,10,6,6,0,0,-2,6,2
"331",331,43,2,"Prosocial","vegetarian",8,6,6,2,2,0,0,2,6,2
"332",332,43,4,"Prosocial","crossroad",9,7,11,1,1,4,0,2,6,2
"333",333,43,6,"Prosocial","sustainable",10,8,8,3,4,0,1,2,6,2
"334",334,43,7,"Prosocial","volunteer",10,8,10,1,1,2,0,2,6,2
"335",335,43,9,"Antisocial","shower",4,6,6,7,5,0,-2,-2,6,2
"336",336,43,11,"Antisocial","meat",7,9,6,7,7,-3,0,-2,6,2
"337",337,43,12,"Antisocial","cyberbully",3,5,1,2,1,-4,-1,-2,6,2
"338",338,44,1,"Prosocial","homeless",9,7,10,2,6,3,4,2,5,2
"339",339,44,2,"Prosocial","crossroad",9,7,10,2,6,3,4,2,5,2
"340",340,44,4,"Prosocial","vegetarian",8,6,6,3,5,0,2,2,5,2
"341",341,44,5,"Prosocial","lendMoney",8,6,6,4,4,0,0,2,5,2
"342",342,44,6,"Antisocial","redlights",3,5,2,3,2,-3,-1,-2,5,2
"343",343,44,9,"Antisocial","lights",4,6,4,2,3,-2,1,-2,5,2
"344",344,44,10,"Antisocial","garbage",3,5,2,3,3,-3,0,-2,5,2
"345",345,44,12,"Antisocial","coughelbow",3,5,2,2,3,-3,1,-2,5,2
"346",346,45,2,"Prosocial","screentime",8,6,7,4,4,1,0,2,3,1
"347",347,45,3,"Antisocial","lights",4,6,5,4,3,-1,-1,-2,3,1
"348",348,45,4,"Antisocial","download",4,6,6,3,5,0,2,-2,3,1
"349",349,45,6,"Prosocial","queue",10,8,11,4,6,3,2,2,3,1
"350",350,45,7,"Prosocial","homeless",10,8,10,5,7,2,2,2,3,1
"351",351,45,9,"Antisocial","coughelbow",4,6,3,2,2,-3,0,-2,3,1
"352",352,45,10,"Prosocial","ownbag",10,8,11,4,6,3,2,2,3,1
"353",353,45,12,"Antisocial","redlights",4,6,1,3,6,-5,3,-2,3,1
"354",354,46,1,"Prosocial","crossroad",11,9,10,2,4,1,2,2,4,2
"355",355,46,3,"Antisocial","chargers",5,7,5,6,6,-2,0,-2,4,2
"356",356,46,5,"Prosocial","lendMoney",8,6,6,2,1,0,-1,2,4,2
"357",357,46,6,"Antisocial","alcoholWork",4,6,6,4,5,0,1,-2,4,2
"358",358,46,8,"Prosocial","queue",11,9,9,4,3,0,-1,2,4,2
"359",359,46,9,"Antisocial","shower",5,7,6,6,6,-1,0,-2,4,2
"360",360,46,10,"Antisocial","late",3,5,5,2,1,0,-1,-2,4,2
"361",361,46,12,"Prosocial","seatBus",10,8,10,3,1,2,-2,2,4,2
"362",362,47,1,"Antisocial","late",4,6,3,3,6,-3,3,-2,4,1
"363",363,47,2,"Antisocial","distance",4,6,2,4,7,-4,3,-2,4,1
"364",364,47,4,"Prosocial","lendMoney",8,6,3,2,6,-3,4,2,4,1
"365",365,47,5,"Prosocial","organicVegetables",6,4,9,3,2,5,-1,2,4,1
"366",366,47,8,"Antisocial","chargers",8,10,11,7,2,1,-5,-2,4,1
"367",367,47,9,"Prosocial","homeless",8,6,2,1,6,-4,5,2,4,1
"368",368,47,11,"Antisocial","meat",7,9,10,7,1,1,-6,-2,4,1
"369",369,47,12,"Prosocial","bike",8,6,11,2,1,5,-1,2,4,1
"370",370,48,1,"Antisocial","chargers",2,4,6,7,7,2,0,-2,4,1
"371",371,48,3,"Antisocial","lights",3,5,4,3,3,-1,0,-2,4,1
"372",372,48,4,"Prosocial","crossroad",10,8,11,5,4,3,-1,2,4,1
"374",374,48,6,"Antisocial","distance",3,5,4,4,4,-1,0,-2,4,1
"375",375,48,9,"Prosocial","vegetarian",11,9,9,5,1,0,-4,2,4,1
"376",376,48,11,"Prosocial","charity",10,8,11,5,6,3,1,2,4,1
"377",377,48,12,"Antisocial","alcoholWork",1,3,1,2,1,-2,-1,-2,4,1
"378",378,49,1,"Antisocial","shower",5,7,7,5,7,0,2,-2,4,1
"379",379,49,2,"Prosocial","homeless",11,9,11,2,7,2,5,2,4,1
"380",380,49,3,"Prosocial","lendMoney",9,7,9,1,7,2,6,2,4,1
"381",381,49,4,"Prosocial","washands",10,8,11,5,7,3,2,2,4,1
"382",382,49,7,"Prosocial","vegetarian",8,6,9,2,6,3,4,2,4,1
"383",383,49,8,"Antisocial","meat",6,8,8,7,7,0,0,-2,4,1
"384",384,49,9,"Antisocial","chargers",5,7,6,4,4,-1,0,-2,4,1
"385",385,49,11,"Antisocial","download",4,6,5,4,5,-1,1,-2,4,1
"386",386,50,1,"Antisocial","meat",7,9,8,7,7,-1,0,-2,5,2
"387",387,50,2,"Prosocial","lendMoney",8,6,9,1,3,3,2,2,5,2
"388",388,50,4,"Prosocial","homeless",11,9,11,2,3,2,1,2,5,2
"389",389,50,5,"Prosocial","queue",7,5,8,2,5,3,3,2,5,2
"390",390,50,7,"Antisocial","download",6,8,9,6,7,1,1,-2,5,2
"392",392,50,11,"Antisocial","chargers",6,8,6,7,7,-2,0,-2,5,2
"393",393,50,12,"Antisocial","shower",5,7,6,6,4,-1,-2,-2,5,2
"394",394,51,1,"Prosocial","speed",10,8,9,2,7,1,5,2,5,2
"395",395,51,2,"Prosocial","organicVegetables",11,9,11,4,7,2,3,2,5,2
"396",396,51,4,"Antisocial","chargers",6,8,9,7,7,1,0,-2,5,2
"397",397,51,5,"Antisocial","noisedisturbance",3,5,4,5,3,-1,-2,-2,5,2
"398",398,51,7,"Antisocial","shower",5,7,7,5,5,0,0,-2,5,2
"399",399,51,8,"Prosocial","vegetarian",10,8,11,1,7,3,6,2,5,2
"400",400,51,11,"Antisocial","meat",7,9,9,7,7,0,0,-2,5,2
"401",401,51,12,"Prosocial","homeless",11,9,11,1,6,2,5,2,5,2
"402",402,52,1,"Antisocial","meat",8,10,9,7,5,-1,-2,-2,4,1
"403",403,52,2,"Prosocial","washands",10,8,10,5,7,2,2,2,4,1
"404",404,52,3,"Antisocial","shower",7,9,7,5,4,-2,-1,-2,4,1
"406",406,52,9,"Antisocial","chargers",2,4,4,6,3,0,-3,-2,4,1
"407",407,52,12,"Prosocial","vegetarian",8,6,8,4,5,2,1,2,4,1
"408",408,53,1,"Antisocial","garbage",1,3,1,5,1,-2,-4,-2,3,1
"409",409,53,3,"Prosocial","vegetarian",8,6,6,1,1,0,0,2,3,1
"410",410,53,4,"Prosocial","lendMoney",8,6,6,1,1,0,0,2,3,1
"411",411,53,5,"Antisocial","shower",4,6,1,5,4,-5,-1,-2,3,1
"412",412,53,6,"Antisocial","lights",1,3,1,7,7,-2,0,-2,3,1
"413",413,53,7,"Prosocial","sustainable",8,6,11,1,1,5,0,2,3,1
"414",414,53,10,"Antisocial","noisedisturbance",1,3,1,7,7,-2,0,-2,3,1
"415",415,53,11,"Prosocial","homeless",8,6,6,1,1,0,0,2,3,1
"416",416,54,1,"Prosocial","lendMoney",9,7,8,4,5,1,1,2,4,2
"417",417,54,2,"Antisocial","distance",8,10,4,7,2,-6,-5,-2,4,2
"418",418,54,4,"Antisocial","redlights",2,4,6,6,4,2,-2,-2,4,2
"420",420,54,7,"Antisocial","late",4,6,5,5,3,-1,-2,-2,4,2
"421",421,54,9,"Antisocial","chargers",4,6,6,7,7,0,0,-2,4,2
"422",422,54,11,"Prosocial","homeless",10,8,8,4,2,0,-2,2,4,2
"423",423,54,12,"Prosocial","bike",8,6,6,5,1,0,-4,2,4,2
"424",424,55,1,"Prosocial","seatBus",10,8,10,2,6,2,4,2,3,2
"425",425,55,2,"Antisocial","distance",5,7,7,6,5,0,-1,-2,3,2
"426",426,55,3,"Prosocial","lendMoney",9,7,7,1,4,0,3,2,3,2
"427",427,55,6,"Prosocial","homeless",6,4,3,1,3,-1,2,2,3,2
"428",428,55,7,"Antisocial","shower",3,5,6,6,4,1,-2,-2,3,2
"429",429,55,8,"Prosocial","ownbag",10,8,10,6,6,2,0,2,3,2
"430",430,55,11,"Antisocial","chargers",7,9,7,5,6,-2,1,-2,3,2
"431",431,55,12,"Antisocial","late",2,4,2,2,2,-2,0,-2,3,2
"432",432,56,2,"Prosocial","recycle",9,7,7,6,5,0,-1,2,4,2
"433",433,56,5,"Prosocial","homeless",10,8,9,3,5,1,2,2,4,2
"434",434,56,6,"Antisocial","late",2,4,2,5,1,-2,-4,-2,4,2
"435",435,56,7,"Prosocial","lendMoney",8,6,6,6,5,0,-1,2,4,2
"436",436,56,8,"Antisocial","chargers",4,6,6,7,7,0,0,-2,4,2
"437",437,56,9,"Antisocial","garbage",1,3,1,2,3,-2,1,-2,4,2
"438",438,56,10,"Prosocial","crossroad",11,9,11,2,3,2,1,2,4,2
"439",439,56,12,"Antisocial","noisedisturbance",1,3,1,2,2,-2,0,-2,4,2
"440",440,57,2,"Prosocial","queue",6,4,4,1,3,0,2,2,3,2
"441",441,57,4,"Prosocial","screentime",8,6,6,6,4,0,-2,2,3,2
"442",442,57,5,"Antisocial","chargers",2,4,3,5,5,-1,0,-2,3,2
"443",443,57,7,"Prosocial","homeless",10,8,8,3,5,0,2,2,3,2
"444",444,57,9,"Antisocial","late",3,5,1,3,1,-4,-2,-2,3,2
"445",445,57,10,"Prosocial","organicVegetables",11,8,9,2,5,1,3,3,3,2
"446",446,57,12,"Antisocial","distance",9,11,10,6,7,-1,1,-2,3,2
"447",447,58,2,"Prosocial","queue",11,9,11,2,1,2,-1,2,3,1
"448",448,58,4,"Antisocial","meat",7,9,8,7,7,-1,0,-2,3,1
"449",449,58,5,"Prosocial","vegetarian",10,8,9,1,2,1,1,2,3,1
"450",450,58,7,"Antisocial","chargers",6,8,6,7,6,-2,-1,-2,3,1
"451",451,58,8,"Prosocial","homeless",9,7,7,1,1,0,0,2,3,1
"452",452,58,9,"Prosocial","lendMoney",9,7,8,2,2,1,0,2,3,1
"453",453,58,10,"Antisocial","redlights",4,6,2,5,4,-4,-1,-2,3,1
"454",454,58,11,"Antisocial","late",3,5,4,6,5,-1,-1,-2,3,1
"455",455,59,1,"Prosocial","ownbag",8,6,5,3,3,-1,0,2,4,1
"456",456,59,2,"Prosocial","seatBus",8,6,5,4,3,-1,-1,2,4,1
"457",457,59,4,"Prosocial","recycle",8,6,7,6,5,1,-1,2,4,1
"458",458,59,5,"Antisocial","late",4,6,2,2,3,-4,1,-2,4,1
"459",459,59,6,"Antisocial","download",4,6,6,2,4,0,2,-2,4,1
"460",460,59,8,"Antisocial","meat",6,8,8,6,6,0,0,-2,4,1
"461",461,59,10,"Prosocial","speed",8,6,6,4,4,0,0,2,4,1
"462",462,59,11,"Antisocial","distance",4,6,6,5,4,0,-1,-2,4,1
"463",463,60,1,"Prosocial","bike",8,6,7,1,1,1,0,2,3,1
"464",464,60,2,"Prosocial","queue",7,5,5,4,1,0,-3,2,3,1
"465",465,60,3,"Antisocial","chargers",5,7,5,7,6,-2,-1,-2,3,1
"466",466,60,4,"Antisocial","shower",5,7,6,7,5,-1,-2,-2,3,1
"467",467,60,5,"Prosocial","lendMoney",7,5,7,5,5,2,0,2,3,1
"468",468,60,6,"Antisocial","late",3,5,4,5,4,-1,-1,-2,3,1
"469",469,60,8,"Antisocial","download",4,6,5,2,2,-1,0,-2,3,1
"470",470,60,10,"Prosocial","charity",10,8,9,2,3,1,1,2,3,1
"471",471,61,2,"Prosocial","lendMoney",8,6,7,3,4,1,1,2,5,1
"472",472,61,4,"Antisocial","lights",4,6,5,5,5,-1,0,-2,5,1
"473",473,61,5,"Antisocial","download",1,3,2,2,2,-1,0,-2,5,1
"474",474,61,6,"Prosocial","sustainable",10,8,11,4,5,3,1,2,5,1
"475",475,61,8,"Prosocial","screentime",8,6,7,1,4,1,3,2,5,1
"476",476,61,10,"Antisocial","shower",4,6,5,2,3,-1,1,-2,5,1
"477",477,61,11,"Antisocial","chargers",4,6,6,7,6,0,-1,-2,5,1
"478",478,61,12,"Prosocial","queue",11,9,10,4,5,1,1,2,5,1
"479",479,62,1,"Antisocial","download",4,6,7,3,4,1,1,-2,2,2
"480",480,62,2,"Prosocial","organicVegetables",11,8,11,4,7,3,3,3,2,2
"481",481,62,3,"Antisocial","distance",4,6,5,7,3,-1,-4,-2,2,2
"482",482,62,5,"Antisocial","chargers",4,6,6,6,5,0,-1,-2,2,2
"484",484,63,1,"Antisocial","coughelbow",1,2,1,2,1,-1,-1,-1,5,1
"485",485,63,3,"Prosocial","volunteer",10,8,11,4,5,3,1,2,5,1
"486",486,63,5,"Prosocial","queue",10,8,11,5,3,3,-2,2,5,1
"487",487,63,6,"Antisocial","chargers",2,4,6,7,7,2,0,-2,5,1
"488",488,63,7,"Antisocial","distance",1,2,3,6,7,1,1,-1,5,1
"489",489,63,8,"Prosocial","homeless",10,8,8,4,1,0,-3,2,5,1
"490",490,63,10,"Prosocial","vegetarian",8,6,6,1,1,0,0,2,5,1
"491",491,63,11,"Antisocial","noisedisturbance",3,6,1,2,5,-5,3,-3,5,1
"492",492,64,1,"Antisocial","heating",1,3,1,4,1,-2,-3,-2,1,1
"493",493,64,2,"Prosocial","homeless",8,6,7,1,2,1,1,2,1,1
"494",494,64,6,"Prosocial","queue",5,3,1,1,1,-2,0,2,1,1
"495",495,64,8,"Antisocial","distance",9,11,8,7,4,-3,-3,-2,1,1
"496",496,64,9,"Antisocial","download",7,9,11,7,7,2,0,-2,1,1
"497",497,64,10,"Antisocial","shower",2,4,4,5,5,0,0,-2,1,1
"498",498,64,11,"Prosocial","seatBus",11,9,6,1,2,-3,1,2,1,1
"499",499,64,12,"Prosocial","lendMoney",8,6,5,1,3,-1,2,2,1,1
"500",500,65,3,"Prosocial","lendMoney",4,2,4,6,5,2,-1,2,3,1
"501",501,65,4,"Antisocial","coughelbow",1,3,1,2,1,-2,-1,-2,3,1
"503",503,65,6,"Antisocial","chargers",9,11,3,6,2,-8,-4,-2,3,1
"504",504,65,7,"Antisocial","distance",1,3,10,2,5,7,3,-2,3,1
"505",505,65,8,"Prosocial","crossroad",11,9,10,6,7,1,1,2,3,1
"506",506,65,9,"Antisocial","meat",9,11,6,6,4,-5,-2,-2,3,1
"507",507,65,10,"Prosocial","speed",10,8,10,6,7,2,1,2,3,1
"508",508,66,1,"Antisocial","late",1,3,1,5,2,-2,-3,-2,5,1
"509",509,66,2,"Antisocial","noisedisturbance",1,3,1,5,3,-2,-2,-2,5,1
"510",510,66,3,"Prosocial","screentime",8,6,9,4,6,3,2,2,5,1
"511",511,66,4,"Antisocial","shower",4,6,4,5,5,-2,0,-2,5,1
"512",512,66,6,"Prosocial","queue",8,6,6,4,4,0,0,2,5,1
"513",513,66,7,"Antisocial","chargers",4,6,6,7,7,0,0,-2,5,1
"514",514,66,8,"Prosocial","homeless",8,6,6,3,5,0,2,2,5,1
"515",515,66,12,"Prosocial","organicVegetables",8,6,6,4,4,0,0,2,5,1
"516",516,67,1,"Prosocial","crossroad",11,9,11,1,1,2,0,2,4,1
"517",517,67,2,"Antisocial","chargers",2,4,5,7,7,1,0,-2,4,1
"518",518,67,3,"Antisocial","lights",3,5,4,7,1,-1,-6,-2,4,1
"519",519,67,6,"Prosocial","bike",10,8,9,1,3,1,2,2,4,1
"520",520,67,9,"Antisocial","distance",3,5,6,7,7,1,0,-2,4,1
"521",521,67,10,"Prosocial","screentime",8,6,6,1,1,0,0,2,4,1
"522",522,67,11,"Antisocial","late",1,3,2,2,2,-1,0,-2,4,1
"523",523,67,12,"Prosocial","queue",11,9,11,5,5,2,0,2,4,1
"524",524,68,2,"Antisocial","heating",5,7,3,2,2,-4,0,-2,4,1
"525",525,68,4,"Prosocial","homeless",11,9,6,4,5,-3,1,2,4,1
"526",526,68,5,"Antisocial","chargers",5,7,6,6,4,-1,-2,-2,4,1
"527",527,68,7,"Prosocial","organicVegetables",11,9,6,1,4,-3,3,2,4,1
"528",528,68,8,"Prosocial","lendMoney",9,7,8,2,5,1,3,2,4,1
"529",529,68,9,"Antisocial","cyberbully",2,4,2,5,1,-2,-4,-2,4,1
"530",530,68,10,"Prosocial","volunteer",10,8,9,5,7,1,2,2,4,1
"531",531,68,11,"Antisocial","gathering",7,9,6,5,4,-3,-1,-2,4,1
"532",532,69,1,"Antisocial","noisedisturbance",1,3,1,2,1,-2,-1,-2,6,1
"533",533,69,2,"Antisocial","meat",9,11,10,7,6,-1,-1,-2,6,1
"534",534,69,3,"Prosocial","ownbag",11,9,11,1,7,2,6,2,6,1
"535",535,69,6,"Antisocial","chargers",4,6,8,7,3,2,-4,-2,6,1
"536",536,69,7,"Antisocial","shower",8,11,10,7,7,-1,0,-3,6,1
"537",537,69,8,"Prosocial","seatBus",11,9,11,1,7,2,6,2,6,1
"538",538,69,10,"Prosocial","charity",11,9,11,1,6,2,5,2,6,1
"539",539,69,11,"Prosocial","sustainable",8,6,9,1,5,3,4,2,6,1
"540",540,70,4,"Prosocial","vegetarian",10,8,10,6,5,2,-1,2,5,1
"541",541,70,6,"Prosocial","bike",9,7,7,1,1,0,0,2,5,1
"542",542,70,7,"Antisocial","lights",2,4,5,3,2,1,-1,-2,5,1
"543",543,70,8,"Prosocial","ownbag",9,7,8,2,2,1,0,2,5,1
"544",544,70,9,"Prosocial","speed",9,7,8,3,4,1,1,2,5,1
"545",545,70,10,"Antisocial","shower",5,7,6,6,6,-1,0,-2,5,1
"546",546,70,11,"Antisocial","chargers",5,7,6,6,5,-1,-1,-2,5,1
"547",547,70,12,"Antisocial","heating",4,6,6,5,4,0,-1,-2,5,1
"548",548,71,1,"Prosocial","organicVegetables",8,6,6,4,5,0,1,2,6,2
"549",549,71,2,"Prosocial","crossroad",9,7,11,2,7,4,5,2,6,2
"550",550,71,3,"Antisocial","taxes",1,3,2,3,3,-1,0,-2,6,2
"551",551,71,5,"Prosocial","volunteer",11,9,10,5,3,1,-2,2,6,2
"552",552,71,7,"Antisocial","noisedisturbance",3,5,2,4,1,-3,-3,-2,6,2
"553",553,71,9,"Prosocial","queue",9,7,6,2,4,-1,2,2,6,2
"554",554,71,11,"Antisocial","coughelbow",1,3,2,3,2,-1,-1,-2,6,2
"555",555,71,12,"Antisocial","distance",8,10,10,6,6,0,0,-2,6,2
"556",556,72,1,"Prosocial","queue",8,6,2,1,2,-4,1,2,3,1
"557",557,72,2,"Antisocial","redlights",3,5,2,4,2,-3,-2,-2,3,1
"558",558,72,3,"Antisocial","meat",7,9,8,7,7,-1,0,-2,3,1
"559",559,72,5,"Prosocial","screentime",8,6,7,1,1,1,0,2,3,1
"560",560,72,6,"Antisocial","download",3,5,5,7,6,0,-1,-2,3,1
"561",561,72,8,"Antisocial","distance",3,5,3,7,5,-2,-2,-2,3,1
"562",562,72,9,"Prosocial","washands",9,7,11,1,2,4,1,2,3,1
"563",563,72,11,"Prosocial","seatBus",11,9,11,1,2,2,1,2,3,1
"564",564,73,1,"Prosocial","queue",10,8,10,6,5,2,-1,2,5,2
"565",565,73,2,"Prosocial","sustainable",11,9,10,3,5,1,2,2,5,2
"566",566,73,3,"Antisocial","shower",5,7,9,5,5,2,0,-2,5,2
"567",567,73,4,"Antisocial","heating",3,5,5,2,2,0,0,-2,5,2
"568",568,73,5,"Antisocial","noisedisturbance",3,5,6,5,3,1,-2,-2,5,2
"569",569,73,7,"Prosocial","ownbag",11,9,11,5,6,2,1,2,5,2
"570",570,73,9,"Antisocial","meat",7,9,9,6,7,0,1,-2,5,2
"571",571,73,11,"Prosocial","volunteer",11,9,11,4,6,2,2,2,5,2
"572",572,74,1,"Prosocial","charity",11,9,8,4,5,-1,1,2,6,2
"573",573,74,2,"Prosocial","ownbag",9,7,9,4,4,2,0,2,6,2
"574",574,74,4,"Prosocial","lendMoney",9,7,8,2,5,1,3,2,6,2
"575",575,74,6,"Antisocial","travelticket",3,5,4,2,3,-1,1,-2,6,2
"576",576,74,7,"Prosocial","organicVegetables",9,7,7,4,3,0,-1,2,6,2
"577",577,74,8,"Antisocial","parking",1,3,1,2,1,-2,-1,-2,6,2
"578",578,74,11,"Antisocial","late",3,5,4,5,3,-1,-2,-2,6,2
"579",579,74,12,"Antisocial","gathering",5,7,10,7,7,3,0,-2,6,2
"580",580,75,2,"Antisocial","gathering",3,5,2,2,1,-3,-1,-2,3,2
"581",581,75,4,"Prosocial","lendMoney",6,4,7,4,5,3,1,2,3,2
"582",582,75,6,"Prosocial","speed",5,3,6,6,3,3,-3,2,3,2
"583",583,75,8,"Antisocial","meat",6,8,8,6,5,0,-1,-2,3,2
"584",584,75,9,"Antisocial","chargers",6,8,7,6,3,-1,-3,-2,3,2
"585",585,75,10,"Prosocial","homeless",10,8,9,6,6,1,0,2,3,2
"586",586,75,11,"Prosocial","bike",8,6,8,2,5,2,3,2,3,2
"587",587,75,12,"Antisocial","shower",5,7,7,4,4,0,0,-2,3,2
"588",588,76,2,"Prosocial","queue",6,4,6,1,3,2,2,2,3,1
"589",589,76,4,"Prosocial","screentime",8,6,7,1,6,1,5,2,3,1
"590",590,76,5,"Antisocial","gathering",4,6,6,5,6,0,1,-2,3,1
"591",591,76,6,"Antisocial","chargers",4,6,6,7,7,0,0,-2,3,1
"593",593,76,10,"Antisocial","distance",4,6,5,6,7,-1,1,-2,3,1
"594",594,76,11,"Antisocial","meat",8,10,9,7,7,-1,0,-2,3,1
"595",595,76,12,"Prosocial","speed",11,9,10,3,7,1,4,2,3,1
"596",596,77,1,"Antisocial","chargers",4,6,3,3,6,-3,3,-2,5,2
"597",597,77,2,"Antisocial","shower",4,6,9,4,5,3,1,-2,5,2
"598",598,77,5,"Prosocial","vegetarian",8,6,6,1,2,0,1,2,5,2
"599",599,77,7,"Prosocial","speed",8,6,8,4,5,2,1,2,5,2
"600",600,77,8,"Prosocial","ownbag",8,6,9,1,1,3,0,2,5,2
"601",601,77,9,"Antisocial","meat",8,10,11,7,7,1,0,-2,5,2
"602",602,77,11,"Prosocial","sustainable",8,6,9,1,2,3,1,2,5,2
"603",603,78,1,"Antisocial","coughelbow",6,8,8,5,5,0,0,-2,5,2
"604",604,78,2,"Antisocial","shower",4,6,5,4,3,-1,-1,-2,5,2
"606",606,78,5,"Prosocial","vegetarian",9,7,6,4,3,-1,-1,2,5,2
"607",607,78,6,"Antisocial","chargers",1,3,3,4,4,0,0,-2,5,2
"608",608,78,7,"Prosocial","sustainable",8,6,9,4,6,3,2,2,5,2
"609",609,78,10,"Prosocial","bike",10,8,8,2,5,0,3,2,5,2
"610",610,78,12,"Antisocial","distance",8,10,7,3,4,-3,1,-2,5,2
"611",611,79,2,"Antisocial","chargers",3,5,4,7,7,-1,0,-2,5,2
"612",612,79,3,"Antisocial","distance",4,6,5,6,2,-1,-4,-2,5,2
"613",613,79,4,"Antisocial","heating",4,6,5,3,1,-1,-2,-2,5,2
"614",614,79,6,"Prosocial","queue",9,7,9,3,5,2,2,2,5,2
"615",615,79,7,"Antisocial","travelticket",4,6,11,7,7,5,0,-2,5,2
"616",616,79,8,"Prosocial","lendMoney",8,6,9,6,6,3,0,2,5,2
"617",617,80,3,"Prosocial","lendMoney",8,6,9,1,2,3,1,2,2,2
"618",618,80,5,"Prosocial","crossroad",10,8,6,4,2,-2,-2,2,2,2
"619",619,80,7,"Antisocial","chargers",4,6,8,5,6,2,1,-2,2,2
"620",620,80,8,"Prosocial","bike",10,8,8,6,3,0,-3,2,2,2
"621",621,80,9,"Antisocial","shower",4,6,7,4,6,1,2,-2,2,2
"622",622,80,10,"Prosocial","charity",10,8,7,5,6,-1,1,2,2,2
"623",623,80,11,"Antisocial","parking",4,6,7,5,5,1,0,-2,2,2
"624",624,80,12,"Antisocial","distance",9,11,7,5,1,-4,-4,-2,2,2
"625",625,81,1,"Antisocial","noisedisturbance",2,4,3,4,3,-1,-1,-2,2,2
"626",626,81,2,"Prosocial","vegetarian",8,6,6,5,3,0,-2,2,2,2
"627",627,81,5,"Antisocial","gathering",4,6,7,5,5,1,0,-2,2,2
"628",628,81,8,"Antisocial","distance",4,6,2,6,2,-4,-4,-2,2,2
"629",629,81,9,"Prosocial","homeless",10,8,6,3,4,-2,1,2,2,2
"630",630,81,10,"Prosocial","bike",10,8,11,5,5,3,0,2,2,2
"631",631,81,11,"Prosocial","speed",8,6,8,3,4,2,1,2,2,2
"632",632,81,12,"Antisocial","heating",5,7,2,3,2,-5,-1,-2,2,2
"633",633,82,1,"Antisocial","distance",8,10,10,6,7,0,1,-2,3,1
"634",634,82,2,"Prosocial","queue",9,7,10,5,6,3,1,2,3,1
"635",635,82,3,"Antisocial","noisedisturbance",1,3,10,6,1,7,-5,-2,3,1
"636",636,82,7,"Antisocial","coughelbow",3,5,10,7,2,5,-5,-2,3,1
"637",637,82,9,"Antisocial","shower",4,6,6,6,5,0,-1,-2,3,1
"638",638,82,10,"Prosocial","crossroad",11,9,11,4,4,2,0,2,3,1
"639",639,82,11,"Prosocial","sustainable",11,9,11,3,5,2,2,2,3,1
"640",640,82,12,"Prosocial","volunteer",11,9,11,4,4,2,0,2,3,1
"641",641,83,1,"Antisocial","gathering",1,3,1,2,3,-2,1,-2,4,1
"642",642,83,2,"Prosocial","homeless",9,7,9,2,7,2,5,2,4,1
"643",643,83,4,"Prosocial","lendMoney",8,6,7,2,5,1,3,2,4,1
"644",644,83,5,"Antisocial","distance",9,11,10,3,6,-1,3,-2,4,1
"645",645,83,6,"Antisocial","download",4,6,5,4,5,-1,1,-2,4,1
"646",646,83,7,"Prosocial","screentime",7,5,7,5,5,2,0,2,4,1
"647",647,83,10,"Antisocial","chargers",4,6,6,7,7,0,0,-2,4,1
"648",648,83,11,"Prosocial","charity",11,9,11,4,7,2,3,2,4,1
"649",649,84,1,"Prosocial","washands",11,9,8,5,5,-1,0,2,2,1
"650",650,84,2,"Antisocial","taxes",1,3,4,2,2,1,0,-2,2,1
"651",651,84,6,"Antisocial","coughelbow",2,4,3,2,2,-1,0,-2,2,1
"652",652,84,7,"Prosocial","volunteer",11,9,8,5,6,-1,1,2,2,1
"653",653,84,8,"Antisocial","lights",3,5,3,3,3,-2,0,-2,2,1
"654",654,84,10,"Antisocial","distance",3,5,4,4,2,-1,-2,-2,2,1
"655",655,84,11,"Prosocial","crossroad",10,8,8,6,6,0,0,2,2,1
"656",656,84,12,"Prosocial","queue",10,8,8,6,5,0,-1,2,2,1
"657",657,85,1,"Antisocial","distance",2,4,4,5,3,0,-2,-2,4,2
"658",658,85,2,"Antisocial","coughelbow",1,3,1,2,2,-2,0,-2,4,2
"659",659,85,3,"Prosocial","homeless",9,7,7,1,3,0,2,2,4,2
"660",660,85,4,"Prosocial","volunteer",9,7,8,1,1,1,0,2,4,2
"661",661,85,5,"Antisocial","shower",8,10,10,7,7,0,0,-2,4,2
"662",662,85,9,"Prosocial","sustainable",8,6,7,3,4,1,1,2,4,2
"663",663,85,11,"Antisocial","heating",6,8,4,2,2,-4,0,-2,4,2
"664",664,85,12,"Prosocial","lendMoney",9,7,6,5,3,-1,-2,2,4,2
"665",665,86,2,"Prosocial","volunteer",11,10,11,3,6,1,3,1,2,2
"666",666,86,3,"Antisocial","distance",1,3,1,3,1,-2,-2,-2,2,2
"667",667,86,5,"Antisocial","lights",4,6,5,3,3,-1,0,-2,2,2
"668",668,86,6,"Antisocial","shower",4,6,4,5,2,-2,-3,-2,2,2
"669",669,86,7,"Antisocial","late",4,6,4,4,3,-2,-1,-2,2,2
"670",670,86,9,"Prosocial","screentime",8,6,6,1,4,0,3,2,2,2
"671",671,87,1,"Antisocial","distance",9,11,11,5,7,0,2,-2,7,2
"672",672,87,6,"Prosocial","bike",11,10,8,1,2,-2,1,1,7,2
"673",673,87,8,"Prosocial","queue",5,1,6,4,1,5,-3,4,7,2
"674",674,87,10,"Prosocial","homeless",9,7,9,1,3,2,2,2,7,2
"675",675,87,11,"Prosocial","lendMoney",9,7,5,1,2,-2,1,2,7,2
"676",676,88,1,"Prosocial","bike",11,9,11,1,7,2,6,2,5,2
"677",677,88,2,"Prosocial","vegetarian",8,6,6,1,3,0,2,2,5,2
"678",678,88,4,"Antisocial","distance",3,5,4,7,5,-1,-2,-2,5,2
"679",679,88,5,"Prosocial","homeless",10,8,6,3,3,-2,0,2,5,2
"680",680,88,7,"Prosocial","screentime",8,6,10,4,6,4,2,2,5,2
"681",681,88,8,"Antisocial","chargers",4,6,6,6,6,0,0,-2,5,2
"682",682,88,9,"Antisocial","lights",2,4,4,2,3,0,1,-2,5,2
"683",683,88,11,"Antisocial","gathering",3,5,2,2,2,-3,0,-2,5,2
"684",684,89,1,"Antisocial","distance",6,9,2,7,3,-7,-4,-3,2,2
"685",685,89,2,"Prosocial","homeless",10,8,3,1,1,-5,0,2,2,2
"686",686,89,3,"Prosocial","queue",6,4,3,2,1,-1,-1,2,2,2
"687",687,89,4,"Antisocial","chargers",7,9,6,7,7,-3,0,-2,2,2
"688",688,89,6,"Antisocial","meat",9,11,11,7,7,0,0,-2,2,2
"689",689,89,7,"Prosocial","crossroad",11,9,8,2,2,-1,0,2,2,2
"690",690,89,10,"Antisocial","shower",7,9,8,7,7,-1,0,-2,2,2
"691",691,89,12,"Prosocial","volunteer",11,9,10,1,5,1,4,2,2,2
"692",692,90,1,"Antisocial","lights",4,6,6,5,5,0,0,-2,2,1
"693",693,90,3,"Antisocial","shower",6,8,7,6,7,-1,1,-2,2,1
"694",694,90,4,"Prosocial","sustainable",10,8,8,6,5,0,-1,2,2,1
"695",695,90,5,"Prosocial","crossroad",10,8,9,4,6,1,2,2,2,1
"696",696,90,7,"Antisocial","meat",6,8,8,7,7,0,0,-2,2,1
"697",697,90,8,"Prosocial","vegetarian",8,6,6,1,2,0,1,2,2,1
"698",698,90,9,"Prosocial","charity",11,9,8,5,5,-1,0,2,2,1
"699",699,90,12,"Antisocial","download",4,6,5,5,5,-1,0,-2,2,1
"700",700,91,2,"Prosocial","queue",11,9,11,3,6,2,3,2,6,1
"701",701,91,3,"Prosocial","screentime",9,7,10,2,6,3,4,2,6,1
"702",702,91,4,"Prosocial","speed",11,9,10,6,6,1,0,2,6,1
"703",703,91,7,"Antisocial","lights",1,3,3,3,2,0,-1,-2,6,1
"704",704,91,8,"Prosocial","bike",11,9,11,1,1,2,0,2,6,1
"705",705,91,9,"Antisocial","chargers",3,5,1,5,3,-4,-2,-2,6,1
"706",706,91,10,"Antisocial","shower",4,6,2,5,4,-4,-1,-2,6,1
"707",707,91,12,"Antisocial","late",4,6,2,5,3,-4,-2,-2,6,1
"708",708,92,1,"Antisocial","distance",1,3,3,6,5,0,-1,-2,5,1
"709",709,92,3,"Prosocial","homeless",9,7,10,3,6,3,3,2,5,1
"710",710,92,4,"Antisocial","shower",3,5,2,2,1,-3,-1,-2,5,1
"711",711,92,6,"Antisocial","gathering",2,4,2,2,2,-2,0,-2,5,1
"712",712,92,8,"Prosocial","seatBus",10,8,10,3,3,2,0,2,5,1
"713",713,92,10,"Antisocial","redlights",2,4,4,3,3,0,0,-2,5,1
"714",714,92,11,"Prosocial","washands",9,7,11,6,7,4,1,2,5,1
"715",715,92,12,"Prosocial","queue",11,9,10,4,5,1,1,2,5,1
"716",716,93,4,"Prosocial","sustainable",10,8,10,5,5,2,0,2,3,1
"717",717,93,5,"Prosocial","vegetarian",9,7,10,5,3,3,-2,2,3,1
"718",718,93,6,"Antisocial","travelticket",1,3,1,2,1,-2,-1,-2,3,1
"719",719,93,7,"Antisocial","meat",5,7,7,7,7,0,0,-2,3,1
"720",720,93,8,"Antisocial","late",1,3,1,2,1,-2,-1,-2,3,1
"721",721,93,9,"Antisocial","heating",3,5,4,2,1,-1,-1,-2,3,1
"722",722,93,10,"Prosocial","screentime",7,5,5,3,2,0,-1,2,3,1
"723",723,93,12,"Prosocial","crossroad",11,9,8,4,3,-1,-1,2,3,1
"724",724,94,2,"Antisocial","shower",4,6,5,5,6,-1,1,-2,3,2
"725",725,94,5,"Prosocial","queue",8,6,8,5,7,2,2,2,3,2
"726",726,94,6,"Antisocial","chargers",4,6,3,7,6,-3,-1,-2,3,2
"727",727,94,7,"Prosocial","charity",11,9,11,5,7,2,2,2,3,2
"728",728,94,8,"Prosocial","bike",10,8,7,1,2,-1,1,2,3,2
"729",729,94,10,"Antisocial","gathering",6,8,4,4,3,-4,-1,-2,3,2
"730",730,94,11,"Prosocial","screentime",8,6,8,3,5,2,2,2,3,2
"731",731,94,12,"Antisocial","distance",9,11,9,7,3,-2,-4,-2,3,2
"732",732,95,1,"Prosocial","speed",11,9,9,6,5,0,-1,2,7,1
"733",733,95,2,"Prosocial","volunteer",11,9,11,4,5,2,1,2,7,1
"734",734,95,5,"Antisocial","noisedisturbance",2,4,1,2,1,-3,-1,-2,7,1
"735",735,95,7,"Prosocial","queue",7,5,8,4,4,3,0,2,7,1
"736",736,95,8,"Antisocial","travelticket",6,8,7,5,5,-1,0,-2,7,1
"737",737,95,9,"Prosocial","sustainable",11,9,11,5,5,2,0,2,7,1
"738",738,95,10,"Antisocial","meat",5,7,6,7,6,-1,-1,-2,7,1
"739",739,95,11,"Antisocial","distance",1,3,1,2,1,-2,-1,-2,7,1
"740",740,96,1,"Prosocial","sustainable",9,7,9,5,7,2,2,2,5,1
"741",741,96,3,"Prosocial","speed",9,7,5,6,3,-2,-3,2,5,1
"742",742,96,4,"Antisocial","late",6,8,6,5,5,-2,0,-2,5,1
"743",743,96,5,"Antisocial","meat",9,11,9,7,6,-2,-1,-2,5,1
"744",744,96,6,"Prosocial","volunteer",10,8,11,6,7,3,1,2,5,1
"745",745,96,7,"Antisocial","travelticket",8,10,10,7,6,0,-1,-2,5,1
"746",746,96,8,"Prosocial","bike",7,5,4,2,3,-1,1,2,5,1
"747",747,96,10,"Antisocial","distance",9,11,11,7,7,0,0,-2,5,1
"748",748,97,3,"Prosocial","ownbag",11,9,10,5,6,1,1,2,5,1
"749",749,97,4,"Prosocial","seatBus",10,8,8,6,5,0,-1,2,5,1
"750",750,97,6,"Antisocial","travelticket",6,8,9,5,5,1,0,-2,5,1
"751",751,97,7,"Prosocial","queue",10,8,9,6,6,1,0,2,5,1
"752",752,97,8,"Antisocial","meat",5,7,7,6,5,0,-1,-2,5,1
"753",753,97,10,"Antisocial","chargers",5,7,7,7,4,0,-3,-2,5,1
"754",754,97,11,"Antisocial","gathering",5,7,7,5,5,0,0,-2,5,1
"755",755,97,12,"Prosocial","facemask",11,9,8,6,6,-1,0,2,5,1
"756",756,98,3,"Prosocial","homeless",10,8,11,2,3,3,1,2,1,2
"757",757,98,4,"Antisocial","chargers",4,6,5,7,7,-1,0,-2,1,2
"758",758,98,5,"Antisocial","heating",3,5,4,3,3,-1,0,-2,1,2
"759",759,98,6,"Prosocial","lendMoney",9,7,9,4,6,2,2,2,1,2
"760",760,98,7,"Prosocial","bike",10,8,11,1,1,3,0,2,1,2
"761",761,98,8,"Antisocial","late",1,3,2,2,2,-1,0,-2,1,2
"762",762,98,10,"Antisocial","meat",5,7,8,7,7,1,0,-2,1,2
"763",763,98,12,"Prosocial","speed",9,7,7,5,4,0,-1,2,1,2
"764",764,99,1,"Antisocial","chargers",4,6,5,5,5,-1,0,-2,3,2
"765",765,99,2,"Prosocial","homeless",8,6,7,1,1,1,0,2,3,2
"766",766,99,5,"Prosocial","crossroad",9,7,9,1,3,2,2,2,3,2
"767",767,99,6,"Antisocial","late",3,5,4,2,2,-1,0,-2,3,2
"768",768,99,7,"Antisocial","shower",4,6,3,2,2,-3,0,-2,3,2
"769",769,99,8,"Antisocial","distance",3,5,3,6,3,-2,-3,-2,3,2
"770",770,99,9,"Prosocial","queue",9,7,8,4,5,1,1,2,3,2
"771",771,99,11,"Prosocial","lendMoney",8,6,6,1,3,0,2,2,3,2
"772",772,100,1,"Prosocial","charity",11,9,11,5,6,2,1,2,4,1
"773",773,100,2,"Prosocial","screentime",10,8,10,6,6,2,0,2,4,1
"774",774,100,3,"Antisocial","lights",1,3,1,3,1,-2,-2,-2,4,1
"775",775,100,5,"Antisocial","shower",1,4,3,6,5,-1,-1,-3,4,1
"776",776,100,7,"Prosocial","vegetarian",7,5,7,3,5,2,2,2,4,1
"777",777,100,8,"Antisocial","chargers",3,5,4,5,5,-1,0,-2,4,1
"778",778,100,9,"Antisocial","meat",7,9,8,7,7,-1,0,-2,4,1
"779",779,100,11,"Prosocial","bike",11,9,7,1,1,-2,0,2,4,1
"780",780,101,2,"Antisocial","redlights",1,3,1,2,1,-2,-1,-2,3,1
"781",781,101,4,"Prosocial","lendMoney",11,9,10,5,5,1,0,2,3,1
"782",782,101,5,"Antisocial","chargers",7,9,6,7,6,-3,-1,-2,3,1
"783",783,101,7,"Prosocial","screentime",11,9,11,5,7,2,2,2,3,1
"784",784,101,8,"Antisocial","late",3,5,4,3,1,-1,-2,-2,3,1
"785",785,101,9,"Antisocial","gathering",5,7,4,5,2,-3,-3,-2,3,1
"786",786,101,12,"Prosocial","speed",11,9,11,5,7,2,2,2,3,1
"787",787,102,1,"Prosocial","washands",11,9,11,5,6,2,1,2,4,1
"788",788,102,2,"Antisocial","meat",9,11,11,7,7,0,0,-2,4,1
"789",789,102,3,"Antisocial","shower",6,8,7,7,4,-1,-3,-2,4,1
"790",790,102,4,"Prosocial","speed",7,5,5,1,2,0,1,2,4,1
"791",791,102,7,"Prosocial","bike",9,7,11,1,6,4,5,2,4,1
"792",792,102,8,"Antisocial","distance",5,7,9,6,6,2,0,-2,4,1
"793",793,102,11,"Antisocial","lights",4,6,6,6,5,0,-1,-2,4,1
"794",794,102,12,"Prosocial","sustainable",6,4,2,2,1,-2,-1,2,4,1
"795",795,103,2,"Prosocial","queue",11,9,10,6,6,1,0,2,4,2
"796",796,103,3,"Antisocial","noisedisturbance",2,4,3,2,2,-1,0,-2,4,2
"797",797,103,4,"Prosocial","sustainable",10,8,11,5,6,3,1,2,4,2
"798",798,103,6,"Antisocial","taxes",1,4,1,1,1,-3,0,-3,4,2
"799",799,103,7,"Antisocial","distance",3,5,4,5,2,-1,-3,-2,4,2
"800",800,103,8,"Antisocial","late",1,3,2,2,1,-1,-1,-2,4,2
"801",801,103,9,"Prosocial","screentime",8,6,6,1,4,0,3,2,4,2
"802",802,103,11,"Prosocial","homeless",10,8,9,4,4,1,0,2,4,2
"803",803,104,1,"Antisocial","chargers",4,6,5,7,7,-1,0,-2,2,1
"804",804,104,2,"Antisocial","meat",5,7,6,7,7,-1,0,-2,2,1
"805",805,104,3,"Prosocial","charity",11,9,11,2,2,2,0,2,2,1
"806",806,104,4,"Prosocial","lendMoney",6,4,6,2,5,2,3,2,2,1
"807",807,104,5,"Prosocial","screentime",10,8,8,1,3,0,2,2,2,1
"808",808,104,7,"Antisocial","lights",4,6,6,7,7,0,0,-2,2,1
"809",809,104,8,"Prosocial","homeless",6,1,5,1,2,4,1,5,2,1
"810",810,104,9,"Antisocial","distance",9,11,10,5,7,-1,2,-2,2,1
"811",811,105,1,"Prosocial","volunteer",11,9,11,1,4,2,3,2,4,1
"812",812,105,4,"Antisocial","distance",6,9,2,4,7,-7,3,-3,4,1
"813",813,105,6,"Antisocial","gathering",1,3,2,2,1,-1,-1,-2,4,1
"814",814,105,7,"Prosocial","screentime",8,6,6,1,2,0,1,2,4,1
"815",815,105,8,"Antisocial","meat",9,11,11,7,7,0,0,-2,4,1
"816",816,105,9,"Antisocial","shower",4,6,3,2,1,-3,-1,-2,4,1
"817",817,105,10,"Prosocial","crossroad",11,9,11,1,7,2,6,2,4,1
"818",818,105,11,"Prosocial","sustainable",9,7,6,1,1,-1,0,2,4,1
"819",819,106,2,"Prosocial","vegetarian",8,6,8,2,5,2,3,2,5,2
"820",820,106,3,"Antisocial","gathering",2,4,2,6,2,-2,-4,-2,5,2
"821",821,106,5,"Prosocial","seatBus",10,8,10,5,5,2,0,2,5,2
"822",822,106,6,"Prosocial","crossroad",10,8,9,1,3,1,2,2,5,2
"823",823,106,8,"Antisocial","distance",2,4,2,5,6,-2,1,-2,5,2
"824",824,106,9,"Prosocial","ownbag",11,9,10,6,6,1,0,2,5,2
"825",825,106,11,"Antisocial","shower",7,9,3,2,5,-6,3,-2,5,2
"826",826,107,2,"Antisocial","shower",3,5,6,7,4,1,-3,-2,4,2
"827",827,107,4,"Prosocial","crossroad",11,9,9,5,6,0,1,2,4,2
"828",828,107,5,"Antisocial","download",1,3,6,3,4,3,1,-2,4,2
"829",829,107,6,"Prosocial","screentime",9,7,6,1,3,-1,2,2,4,2
"830",830,107,7,"Prosocial","bike",9,7,8,1,2,1,1,2,4,2
"831",831,107,9,"Antisocial","lights",2,4,2,3,1,-2,-2,-2,4,2
"832",832,107,11,"Prosocial","vegetarian",10,8,7,3,2,-1,-1,2,4,2
"833",833,107,12,"Antisocial","chargers",4,6,4,7,4,-2,-3,-2,4,2
"834",834,108,1,"Prosocial","bike",9,7,9,1,1,2,0,2,5,1
"835",835,108,2,"Antisocial","redlights",2,4,3,3,2,-1,-1,-2,5,1
"836",836,108,3,"Prosocial","washands",9,7,10,3,5,3,2,2,5,1
"837",837,108,5,"Antisocial","chargers",4,6,7,2,2,1,0,-2,5,1
"838",838,108,6,"Antisocial","parking",2,4,1,2,2,-3,0,-2,5,1
"839",839,108,9,"Prosocial","screentime",8,6,10,1,1,4,0,2,5,1
"840",840,108,11,"Antisocial","download",6,8,9,2,6,1,4,-2,5,1
"841",841,108,12,"Prosocial","queue",8,6,8,2,4,2,2,2,5,1
"842",842,109,1,"Antisocial","shower",4,6,4,3,2,-2,-1,-2,3,1
"843",843,109,3,"Prosocial","screentime",8,6,9,5,7,3,2,2,3,1
"844",844,109,4,"Antisocial","chargers",4,6,4,5,3,-2,-2,-2,3,1
"845",845,109,6,"Antisocial","meat",7,9,9,3,6,0,3,-2,3,1
"846",846,109,7,"Antisocial","travelticket",3,5,4,2,2,-1,0,-2,3,1
"847",847,109,8,"Prosocial","charity",8,6,9,4,6,3,2,2,3,1
"848",848,109,11,"Prosocial","bike",8,6,8,1,3,2,2,2,3,1
"849",849,109,12,"Prosocial","homeless",10,8,10,4,5,2,1,2,3,1
"850",850,110,1,"Prosocial","bike",8,6,6,1,4,0,3,2,2,2
"851",851,110,4,"Prosocial","queue",10,8,6,1,2,-2,1,2,2,2
"852",852,110,6,"Antisocial","distance",9,11,1,7,7,-10,0,-2,2,2
"853",853,110,8,"Antisocial","chargers",5,7,6,7,7,-1,0,-2,2,2
"854",854,110,10,"Prosocial","screentime",8,6,6,5,7,0,2,2,2,2
"855",855,110,12,"Prosocial","lendMoney",8,6,6,1,1,0,0,2,2,2
"856",856,111,1,"Antisocial","distance",4,6,11,7,4,5,-3,-2,1,1
"857",857,111,2,"Prosocial","sustainable",8,6,6,1,4,0,3,2,1,1
"858",858,111,3,"Prosocial","bike",8,6,8,2,4,2,2,2,1,1
"859",859,111,4,"Antisocial","lights",4,6,7,7,6,1,-1,-2,1,1
"860",860,111,6,"Antisocial","shower",4,6,5,4,2,-1,-2,-2,1,1
"861",861,111,9,"Prosocial","queue",8,6,6,4,3,0,-1,2,1,1
"862",862,111,11,"Antisocial","chargers",4,6,6,7,7,0,0,-2,1,1
"863",863,111,12,"Prosocial","volunteer",8,6,10,1,1,4,0,2,1,1
"864",864,112,1,"Prosocial","screentime",10,8,10,2,2,2,0,2,3,1
"865",865,112,2,"Antisocial","gathering",3,5,8,7,5,3,-2,-2,3,1
"866",866,112,4,"Antisocial","chargers",7,9,9,7,7,0,0,-2,3,1
"867",867,112,5,"Prosocial","sustainable",9,7,10,4,7,3,3,2,3,1
"868",868,112,7,"Prosocial","queue",9,7,10,5,7,3,2,2,3,1
"869",869,112,10,"Antisocial","distance",9,11,11,7,4,0,-3,-2,3,1
"870",870,112,11,"Antisocial","shower",9,11,10,5,7,-1,2,-2,3,1
"871",871,113,2,"Antisocial","shower",4,6,5,5,4,-1,-1,-2,3,2
"872",872,113,4,"Antisocial","late",3,5,3,2,2,-2,0,-2,3,2
"873",873,113,6,"Prosocial","charity",9,7,8,4,4,1,0,2,3,2
"874",874,113,7,"Prosocial","queue",8,6,6,4,4,0,0,2,3,2
"875",875,113,8,"Prosocial","crossroad",9,7,8,1,3,1,2,2,3,2
"876",876,113,9,"Prosocial","recycle",10,8,9,6,6,1,0,2,3,2
"877",877,113,10,"Antisocial","distance",3,5,2,3,2,-3,-1,-2,3,2
"878",878,113,12,"Antisocial","gathering",2,4,1,2,2,-3,0,-2,3,2
"879",879,114,1,"Prosocial","volunteer",9,7,8,1,5,1,4,2,2,1
"880",880,114,3,"Antisocial","chargers",4,6,5,7,7,-1,0,-2,2,1
"881",881,114,5,"Antisocial","shower",5,7,7,7,7,0,0,-2,2,1
"882",882,114,8,"Prosocial","charity",9,7,8,3,4,1,1,2,2,1
"883",883,114,9,"Antisocial","late",4,6,5,5,4,-1,-1,-2,2,1
"884",884,114,10,"Prosocial","bike",9,7,8,4,5,1,1,2,2,1
"885",885,114,11,"Antisocial","gathering",1,3,3,3,2,0,-1,-2,2,1
"886",886,114,12,"Prosocial","seatBus",9,7,8,5,5,1,0,2,2,1
"887",887,115,1,"Prosocial","homeless",10,8,8,4,2,0,-2,2,3,1
"888",888,115,4,"Antisocial","noisedisturbance",1,3,1,2,4,-2,2,-2,3,1
"889",889,115,5,"Prosocial","speed",9,7,8,5,6,1,1,2,3,1
"890",890,115,7,"Antisocial","heating",2,4,1,3,1,-3,-2,-2,3,1
"891",891,115,8,"Antisocial","late",2,4,2,2,3,-2,1,-2,3,1
"892",892,115,9,"Prosocial","lendMoney",7,5,6,3,2,1,-1,2,3,1
"893",893,115,11,"Prosocial","recycle",11,9,11,6,7,2,1,2,3,1
"894",894,115,12,"Antisocial","meat",5,7,7,7,6,0,-1,-2,3,1
"895",895,116,1,"Antisocial","download",4,6,7,4,3,1,-1,-2,4,1
"896",896,116,3,"Prosocial","screentime",8,6,8,1,4,2,3,2,4,1
"897",897,116,4,"Prosocial","lendMoney",11,9,6,4,5,-3,1,2,4,1
"898",898,116,5,"Antisocial","lights",4,6,4,2,2,-2,0,-2,4,1
"899",899,116,7,"Prosocial","charity",11,9,10,4,4,1,0,2,4,1
"900",900,116,9,"Antisocial","distance",9,11,11,7,7,0,0,-2,4,1
"901",901,116,11,"Antisocial","shower",4,6,5,7,6,-1,-1,-2,4,1
"902",902,116,12,"Prosocial","queue",11,9,10,6,6,1,0,2,4,1
"903",903,117,2,"Prosocial","queue",8,6,7,3,3,1,0,2,4,1
"904",904,117,3,"Prosocial","recycle",11,9,10,6,7,1,1,2,4,1
"905",905,117,4,"Antisocial","distance",5,7,6,6,5,-1,-1,-2,4,1
"906",906,117,5,"Antisocial","travelticket",4,6,5,2,1,-1,-1,-2,4,1
"907",907,117,7,"Antisocial","chargers",4,6,6,6,7,0,1,-2,4,1
"908",908,117,8,"Prosocial","ownbag",11,9,11,6,7,2,1,2,4,1
"909",909,117,9,"Antisocial","coughelbow",3,5,3,2,4,-2,2,-2,4,1
"910",910,117,12,"Prosocial","speed",6,4,4,2,1,0,-1,2,4,1
"911",911,118,1,"Prosocial","queue",10,8,8,5,5,0,0,2,5,2
"912",912,118,3,"Antisocial","gathering",3,5,2,6,4,-3,-2,-2,5,2
"913",913,118,6,"Prosocial","speed",11,9,11,6,7,2,1,2,5,2
"914",914,118,7,"Prosocial","vegetarian",10,8,10,2,5,2,3,2,5,2
"915",915,118,8,"Antisocial","heating",4,6,6,4,3,0,-1,-2,5,2
"916",916,118,9,"Antisocial","meat",8,10,10,7,6,0,-1,-2,5,2
"917",917,118,10,"Prosocial","bike",11,9,7,1,4,-2,3,2,5,2
"918",918,118,12,"Antisocial","chargers",4,6,2,4,4,-4,0,-2,5,2
"919",919,119,1,"Prosocial","sustainable",10,8,11,4,4,3,0,2,1,2
"920",920,119,2,"Prosocial","speed",8,6,6,1,5,0,4,2,1,2
"921",921,119,3,"Antisocial","travelticket",6,8,6,4,1,-2,-3,-2,1,2
"922",922,119,6,"Antisocial","gathering",2,4,2,5,2,-2,-3,-2,1,2
"923",923,119,7,"Antisocial","chargers",4,6,9,7,6,3,-1,-2,1,2
"924",924,119,8,"Prosocial","homeless",8,6,9,1,2,3,1,2,1,2
"925",925,119,10,"Prosocial","crossroad",8,6,6,1,3,0,2,2,1,2
"926",926,119,12,"Antisocial","shower",1,3,1,7,2,-2,-5,-2,1,2
"927",927,120,1,"Antisocial","chargers",4,6,6,4,4,0,0,-2,3,1
"928",928,120,2,"Antisocial","travelticket",6,9,9,4,5,0,1,-3,3,1
"929",929,120,3,"Antisocial","shower",5,7,6,6,4,-1,-2,-2,3,1
"930",930,120,9,"Antisocial","download",7,9,8,7,6,-1,-1,-2,3,1
"931",931,120,11,"Prosocial","lendMoney",11,9,7,5,6,-2,1,2,3,1
"932",932,121,1,"Antisocial","lights",4,6,4,6,5,-2,-1,-2,3,2
"933",933,121,2,"Prosocial","vegetarian",8,6,4,1,1,-2,0,2,3,2
"934",934,121,4,"Prosocial","crossroad",10,8,8,2,3,0,1,2,3,2
"935",935,121,6,"Antisocial","distance",8,10,10,7,6,0,-1,-2,3,2
"936",936,121,8,"Prosocial","homeless",9,7,6,2,2,-1,0,2,3,2
"937",937,121,9,"Antisocial","garbage",1,3,2,3,1,-1,-2,-2,3,2
"938",938,121,10,"Antisocial","meat",8,10,10,7,7,0,0,-2,3,2
"939",939,121,11,"Prosocial","queue",8,6,6,4,3,0,-1,2,3,2
"940",940,122,1,"Antisocial","chargers",5,7,11,7,7,4,0,-2,2,1
"941",941,122,4,"Prosocial","screentime",9,7,6,1,2,-1,1,2,2,1
"942",942,122,5,"Prosocial","homeless",10,8,1,1,1,-7,0,2,2,1
"943",943,122,6,"Prosocial","speed",6,3,1,5,1,-2,-4,3,2,1
"944",944,122,7,"Antisocial","shower",8,10,11,7,7,1,0,-2,2,1
"945",945,122,8,"Antisocial","distance",4,6,11,7,7,5,0,-2,2,1
"946",946,122,9,"Prosocial","lendMoney",7,5,6,3,1,1,-2,2,2,1
"947",947,122,11,"Antisocial","meat",9,11,11,7,7,0,0,-2,2,1
"948",948,123,1,"Antisocial","download",5,7,5,3,4,-2,1,-2,5,2
"949",949,123,2,"Prosocial","screentime",10,8,11,5,7,3,2,2,5,2
"950",950,123,6,"Antisocial","chargers",7,9,9,7,7,0,0,-2,5,2
"951",951,123,7,"Prosocial","speed",9,7,8,5,4,1,-1,2,5,2
"952",952,123,8,"Prosocial","charity",10,8,11,1,7,3,6,2,5,2
"953",953,123,9,"Prosocial","washands",11,9,11,5,6,2,1,2,5,2
"954",954,123,10,"Antisocial","meat",9,11,10,7,7,-1,0,-2,5,2
"955",955,123,11,"Antisocial","distance",4,6,3,5,3,-3,-2,-2,5,2
"956",956,124,1,"Antisocial","cyberbully",3,5,4,4,3,-1,-1,-2,2,2
"957",957,124,4,"Prosocial","speed",9,7,7,3,5,0,2,2,2,2
"958",958,124,5,"Prosocial","screentime",8,6,7,4,4,1,0,2,2,2
"959",959,124,6,"Antisocial","chargers",4,6,6,7,6,0,-1,-2,2,2
"960",960,124,7,"Antisocial","lights",3,5,4,2,2,-1,0,-2,2,2
"961",961,124,8,"Prosocial","vegetarian",10,8,8,1,5,0,4,2,2,2
"962",962,124,10,"Prosocial","sustainable",8,6,7,1,4,1,3,2,2,2
"963",963,124,12,"Antisocial","shower",3,5,6,2,4,1,2,-2,2,2
"964",964,125,2,"Prosocial","screentime",11,9,9,4,6,0,2,2,6,1
"965",965,125,3,"Antisocial","lights",1,3,6,3,2,3,-1,-2,6,1
"966",966,125,4,"Prosocial","vegetarian",11,9,11,6,7,2,1,2,6,1
"967",967,125,5,"Antisocial","coughelbow",4,6,2,6,2,-4,-4,-2,6,1
"968",968,125,8,"Prosocial","ownbag",10,8,10,6,7,2,1,2,6,1
"969",969,125,9,"Antisocial","late",1,3,1,3,1,-2,-2,-2,6,1
"970",970,125,10,"Antisocial","noisedisturbance",1,3,1,5,2,-2,-3,-2,6,1
"971",971,125,11,"Prosocial","bike",8,6,8,4,6,2,2,2,6,1
"972",972,126,2,"Prosocial","vegetarian",11,9,8,4,4,-1,0,2,4,2
"973",973,126,3,"Antisocial","shower",4,6,8,7,4,2,-3,-2,4,2
"974",974,126,5,"Prosocial","queue",11,9,11,6,6,2,0,2,4,2
"975",975,126,8,"Prosocial","screentime",8,6,6,6,6,0,0,2,4,2
"976",976,126,9,"Antisocial","download",4,6,6,4,4,0,0,-2,4,2
"977",977,126,10,"Antisocial","chargers",4,6,4,7,2,-2,-5,-2,4,2
"978",978,126,11,"Prosocial","homeless",8,6,8,5,5,2,0,2,4,2
"979",979,127,1,"Prosocial","queue",8,6,8,3,5,2,2,2,3,1
"980",980,127,3,"Prosocial","homeless",8,6,7,1,4,1,3,2,3,1
"981",981,127,5,"Antisocial","lights",5,7,4,6,2,-3,-4,-2,3,1
"982",982,127,6,"Prosocial","bike",9,7,8,1,5,1,4,2,3,1
"983",983,127,9,"Antisocial","shower",4,6,4,7,2,-2,-5,-2,3,1
"984",984,127,10,"Antisocial","noisedisturbance",1,3,1,5,1,-2,-4,-2,3,1
"985",985,127,11,"Antisocial","chargers",3,5,3,7,2,-2,-5,-2,3,1
"986",986,127,12,"Prosocial","screentime",9,7,9,6,5,2,-1,2,3,1
"987",987,128,1,"Prosocial","lendMoney",9,7,7,2,5,0,3,2,2,2
"988",988,128,3,"Prosocial","charity",11,9,10,5,4,1,-1,2,2,2
"989",989,128,4,"Antisocial","redlights",2,4,7,3,3,3,0,-2,2,2
"990",990,128,6,"Prosocial","homeless",11,9,10,4,4,1,0,2,2,2
"991",991,128,7,"Prosocial","vegetarian",10,8,10,3,3,2,0,2,2,2
"992",992,128,10,"Antisocial","download",3,5,8,4,4,3,0,-2,2,2
"993",993,128,11,"Antisocial","coughelbow",1,3,2,2,2,-1,0,-2,2,2
"994",994,128,12,"Antisocial","lights",4,6,5,2,5,-1,3,-2,2,2
"995",995,129,1,"Antisocial","chargers",5,7,5,6,4,-2,-2,-2,7,1
"996",996,129,3,"Prosocial","homeless",9,7,8,2,4,1,2,2,7,1
"997",997,129,4,"Prosocial","charity",10,8,9,4,7,1,3,2,7,1
"998",998,129,5,"Prosocial","seatBus",8,6,8,2,5,2,3,2,7,1
"999",999,129,7,"Prosocial","speed",7,5,6,4,6,1,2,2,7,1
"1000",1000,129,9,"Antisocial","distance",9,11,11,7,7,0,0,-2,7,1
"1001",1001,129,10,"Antisocial","gathering",3,5,3,2,2,-2,0,-2,7,1
"1002",1002,129,12,"Antisocial","meat",6,8,6,6,6,-2,0,-2,7,1
"1003",1003,130,2,"Antisocial","redlights",2,4,1,2,2,-3,0,-2,5,1
"1004",1004,130,3,"Antisocial","distance",2,4,1,4,1,-3,-3,-2,5,1
"1005",1005,130,4,"Prosocial","recycle",9,7,8,5,6,1,1,2,5,1
"1006",1006,130,6,"Antisocial","noisedisturbance",1,3,1,3,1,-2,-2,-2,5,1
"1007",1007,130,9,"Prosocial","crossroad",9,7,8,3,5,1,2,2,5,1
"1008",1008,130,10,"Prosocial","bike",8,6,8,1,5,2,4,2,5,1
"1009",1009,130,11,"Prosocial","homeless",7,5,4,1,2,-1,1,2,5,1
"1010",1010,130,12,"Antisocial","chargers",4,6,8,7,5,2,-2,-2,5,1
"1011",1011,131,1,"Antisocial","shower",4,6,5,2,3,-1,1,-2,5,1
"1012",1012,131,2,"Prosocial","queue",8,6,8,3,6,2,3,2,5,1
"1013",1013,131,3,"Antisocial","chargers",4,6,5,7,5,-1,-2,-2,5,1
"1014",1014,131,4,"Prosocial","volunteer",9,7,10,6,7,3,1,2,5,1
"1015",1015,131,8,"Prosocial","homeless",8,6,7,2,3,1,1,2,5,1
"1016",1016,131,9,"Antisocial","download",5,7,7,5,7,0,2,-2,5,1
"1017",1017,131,10,"Prosocial","screentime",9,7,9,5,4,2,-1,2,5,1
"1018",1018,131,11,"Antisocial","heating",4,6,5,3,1,-1,-2,-2,5,1
"1019",1019,132,1,"Prosocial","homeless",10,8,10,3,7,2,4,2,4,1
"1020",1020,132,2,"Prosocial","lendMoney",8,6,7,5,5,1,0,2,4,1
"1021",1021,132,3,"Antisocial","travelticket",2,4,7,2,3,3,1,-2,4,1
"1022",1022,132,6,"Antisocial","chargers",4,6,6,5,6,0,1,-2,4,1
"1023",1023,132,8,"Antisocial","late",2,4,3,3,2,-1,-1,-2,4,1
"1024",1024,132,9,"Prosocial","vegetarian",8,6,11,2,7,5,5,2,4,1
"1025",1025,132,10,"Prosocial","speed",11,9,9,5,5,0,0,2,4,1
"1026",1026,132,11,"Antisocial","distance",9,11,8,7,4,-3,-3,-2,4,1
"1027",1027,133,1,"Prosocial","volunteer",10,8,8,6,6,0,0,2,4,2
"1028",1028,133,2,"Prosocial","crossroad",9,7,11,5,7,4,2,2,4,2
"1029",1029,133,3,"Prosocial","ownbag",10,8,11,5,7,3,2,2,4,2
"1030",1030,133,5,"Antisocial","garbage",1,3,1,3,2,-2,-1,-2,4,2
"1031",1031,133,7,"Antisocial","noisedisturbance",2,4,3,2,2,-1,0,-2,4,2
"1032",1032,133,9,"Antisocial","shower",4,6,2,5,3,-4,-2,-2,4,2
"1033",1033,133,10,"Prosocial","vegetarian",6,4,1,1,1,-3,0,2,4,2
"1034",1034,133,11,"Antisocial","distance",9,11,7,5,5,-4,0,-2,4,2
"1035",1035,134,1,"Prosocial","charity",10,8,9,5,6,1,1,2,4,1
"1036",1036,134,2,"Antisocial","gathering",4,6,6,4,3,0,-1,-2,4,1
"1037",1037,134,3,"Prosocial","sustainable",8,6,6,4,4,0,0,2,4,1
"1038",1038,134,5,"Antisocial","shower",4,6,6,5,4,0,-1,-2,4,1
"1039",1039,134,7,"Antisocial","meat",6,8,9,7,6,1,-1,-2,4,1
"1040",1040,134,8,"Antisocial","taxes",2,4,2,2,2,-2,0,-2,4,1
"1041",1041,134,9,"Prosocial","speed",9,7,9,4,4,2,0,2,4,1
"1042",1042,134,11,"Prosocial","queue",9,7,7,4,5,0,1,2,4,1
"1043",1043,135,1,"Prosocial","queue",7,5,6,3,4,1,1,2,5,2
"1044",1044,135,2,"Prosocial","screentime",5,3,2,3,5,-1,2,2,5,2
"1045",1045,135,3,"Prosocial","vegetarian",11,9,9,2,6,0,4,2,5,2
"1046",1046,135,6,"Antisocial","meat",6,8,6,6,6,-2,0,-2,5,2
"1047",1047,135,7,"Antisocial","late",1,3,1,2,2,-2,0,-2,5,2
"1048",1048,135,8,"Antisocial","shower",7,9,6,6,5,-3,-1,-2,5,2
"1049",1049,135,11,"Antisocial","chargers",4,6,6,7,6,0,-1,-2,5,2
"1050",1050,135,12,"Prosocial","charity",11,9,11,4,7,2,3,2,5,2
"1051",1051,136,3,"Antisocial","download",6,8,7,6,5,-1,-1,-2,5,1
"1052",1052,136,4,"Antisocial","noisedisturbance",1,3,1,2,2,-2,0,-2,5,1
"1053",1053,136,5,"Prosocial","bike",10,8,7,1,2,-1,1,2,5,1
"1054",1054,136,6,"Prosocial","ownbag",11,9,10,5,5,1,0,2,5,1
"1055",1055,136,7,"Prosocial","seatBus",11,9,10,5,6,1,1,2,5,1
"1056",1056,136,8,"Antisocial","chargers",4,6,5,6,5,-1,-1,-2,5,1
"1057",1057,136,9,"Prosocial","crossroad",11,9,11,5,5,2,0,2,5,1
"1058",1058,136,12,"Antisocial","gathering",4,6,5,3,2,-1,-1,-2,5,1
"1059",1059,137,1,"Antisocial","lights",2,4,3,6,4,-1,-2,-2,5,2
"1060",1060,137,2,"Antisocial","chargers",4,6,4,7,4,-2,-3,-2,5,2
"1061",1061,137,4,"Antisocial","download",4,6,7,4,7,1,3,-2,5,2
"1062",1062,137,5,"Prosocial","queue",10,8,9,4,5,1,1,2,5,2
"1063",1063,137,7,"Prosocial","volunteer",11,9,9,4,6,0,2,2,5,2
"1064",1064,137,8,"Prosocial","lendMoney",9,7,8,4,4,1,0,2,5,2
"1065",1065,137,11,"Antisocial","shower",6,8,4,7,7,-4,0,-2,5,2
"1066",1066,137,12,"Prosocial","bike",11,9,8,1,2,-1,1,2,5,2
"1067",1067,138,1,"Antisocial","meat",5,7,7,7,7,0,0,-2,5,2
"1068",1068,138,2,"Antisocial","distance",6,8,8,7,6,0,-1,-2,5,2
"1069",1069,138,4,"Prosocial","queue",11,9,10,3,5,1,2,2,5,2
"1070",1070,138,5,"Prosocial","speed",11,9,6,1,2,-3,1,2,5,2
"1071",1071,138,8,"Prosocial","lendMoney",6,4,2,1,2,-2,1,2,5,2
"1072",1072,138,9,"Antisocial","gathering",3,5,6,2,3,1,1,-2,5,2
"1073",1073,138,10,"Antisocial","lights",1,3,3,4,2,0,-2,-2,5,2
"1074",1074,138,11,"Prosocial","charity",11,9,11,5,7,2,2,2,5,2
"1075",1075,139,2,"Prosocial","lendMoney",11,8,2,5,1,-6,-4,3,4,2
"1076",1076,139,5,"Antisocial","chargers",3,5,3,7,7,-2,0,-2,4,2
"1077",1077,139,6,"Antisocial","shower",3,5,2,3,4,-3,1,-2,4,2
"1078",1078,139,9,"Prosocial","speed",7,5,6,4,1,1,-3,2,4,2
"1079",1079,140,3,"Antisocial","meat",8,10,11,7,7,1,0,-2,3,1
"1080",1080,140,6,"Antisocial","distance",9,11,10,5,6,-1,1,-2,3,1
"1081",1081,140,7,"Prosocial","ownbag",11,9,11,5,7,2,2,2,3,1
"1082",1082,140,8,"Prosocial","bike",10,8,9,2,4,1,2,2,3,1
"1083",1083,140,9,"Prosocial","screentime",9,7,8,5,6,1,1,2,3,1
"1084",1084,140,10,"Antisocial","chargers",3,5,4,3,4,-1,1,-2,3,1
"1085",1085,140,11,"Antisocial","alcoholWork",1,3,1,3,1,-2,-2,-2,3,1
"1086",1086,141,1,"Antisocial","travelticket",5,7,6,3,5,-1,2,-2,6,2
"1087",1087,141,3,"Prosocial","seatBus",10,8,10,1,6,2,5,2,6,2
"1088",1088,141,4,"Antisocial","chargers",9,11,11,7,7,0,0,-2,6,2
"1089",1089,141,5,"Prosocial","volunteer",9,7,3,2,2,-4,0,2,6,2
"1090",1090,141,6,"Antisocial","download",5,7,8,4,6,1,2,-2,6,2
"1091",1091,141,8,"Prosocial","speed",6,4,5,1,3,1,2,2,6,2
"1092",1092,141,9,"Antisocial","lights",2,4,2,5,1,-2,-4,-2,6,2
"1093",1093,141,10,"Prosocial","charity",10,8,8,3,5,0,2,2,6,2
"1094",1094,142,1,"Antisocial","download",6,8,9,6,5,1,-1,-2,5,2
"1095",1095,142,2,"Prosocial","vegetarian",8,6,10,4,5,4,1,2,5,2
"1096",1096,142,3,"Antisocial","meat",7,9,11,7,6,2,-1,-2,5,2
"1097",1097,142,4,"Prosocial","lendMoney",11,9,8,5,6,-1,1,2,5,2
"1098",1098,142,5,"Antisocial","shower",4,6,7,5,4,1,-1,-2,5,2
"1099",1099,142,6,"Antisocial","chargers",4,6,5,7,4,-1,-3,-2,5,2
"1100",1100,142,9,"Prosocial","queue",8,6,9,6,6,3,0,2,5,2
"1101",1101,143,1,"Prosocial","screentime",8,6,7,1,4,1,3,2,6,2
"1102",1102,143,2,"Antisocial","distance",4,6,6,7,4,0,-3,-2,6,2
"1103",1103,143,4,"Antisocial","heating",4,6,10,7,4,4,-3,-2,6,2
"1104",1104,143,5,"Prosocial","charity",10,8,10,6,6,2,0,2,6,2
"1105",1105,143,7,"Prosocial","ownbag",10,8,11,4,7,3,3,2,6,2
"1106",1106,143,8,"Antisocial","shower",9,11,10,7,6,-1,-1,-2,6,2
"1107",1107,143,10,"Antisocial","meat",9,11,9,7,6,-2,-1,-2,6,2
"1108",1108,143,11,"Prosocial","lendMoney",9,7,9,4,6,2,2,2,6,2
"1109",1109,144,1,"Prosocial","seatBus",10,8,7,5,5,-1,0,2,5,1
"1110",1110,144,4,"Antisocial","taxes",2,4,1,3,1,-3,-2,-2,5,1
"1111",1111,144,5,"Antisocial","redlights",2,4,4,2,2,0,0,-2,5,1
"1112",1112,144,6,"Prosocial","ownbag",9,7,7,5,5,0,0,2,5,1
"1113",1113,144,7,"Antisocial","travelticket",1,3,3,3,2,0,-1,-2,5,1
"1114",1114,144,8,"Prosocial","volunteer",10,8,6,5,5,-2,0,2,5,1
"1115",1115,144,11,"Antisocial","noisedisturbance",1,3,4,2,2,1,0,-2,5,1
"1116",1116,144,12,"Prosocial","homeless",9,7,9,5,6,2,1,2,5,1
"1117",1117,145,1,"Prosocial","recycle",10,8,9,2,6,1,4,2,4,1
"1118",1118,145,2,"Antisocial","shower",4,6,6,6,3,0,-3,-2,4,1
"1119",1119,145,4,"Prosocial","screentime",8,6,7,5,6,1,1,2,4,1
"1120",1120,145,5,"Antisocial","distance",1,3,1,2,1,-2,-1,-2,4,1
"1121",1121,145,9,"Prosocial","sustainable",8,6,7,4,5,1,1,2,4,1
"1122",1122,145,10,"Antisocial","download",2,4,2,3,2,-2,-1,-2,4,1
"1123",1123,145,11,"Prosocial","vegetarian",8,6,6,4,4,0,0,2,4,1
"1124",1124,145,12,"Antisocial","meat",6,8,7,7,6,-1,-1,-2,4,1
"1125",1125,146,1,"Antisocial","noisedisturbance",2,4,4,2,3,0,1,-2,3,2
"1126",1126,146,2,"Antisocial","download",2,4,4,2,4,0,2,-2,3,2
"1127",1127,146,3,"Antisocial","gathering",2,4,6,3,4,2,1,-2,3,2
"1128",1128,146,4,"Prosocial","crossroad",10,8,9,2,2,1,0,2,3,2
"1129",1129,146,5,"Prosocial","charity",10,8,11,6,6,3,0,2,3,2
"1130",1130,146,6,"Prosocial","bike",10,8,6,1,2,-2,1,2,3,2
"1131",1131,146,7,"Prosocial","facemask",11,9,7,5,5,-2,0,2,3,2
"1132",1132,146,9,"Antisocial","chargers",4,6,6,6,6,0,0,-2,3,2
"1133",1133,147,1,"Prosocial","lendMoney",9,7,8,5,5,1,0,2,3,2
"1134",1134,147,3,"Prosocial","queue",8,6,6,4,4,0,0,2,3,2
"1135",1135,147,7,"Antisocial","meat",9,11,9,5,5,-2,0,-2,3,2
"1136",1136,147,11,"Antisocial","distance",9,11,8,6,5,-3,-1,-2,3,2
"1137",1137,148,1,"Antisocial","chargers",3,5,4,7,3,-1,-4,-2,5,1
"1138",1138,148,3,"Prosocial","volunteer",11,9,10,1,2,1,1,2,5,1
"1139",1139,148,4,"Prosocial","homeless",11,9,7,2,1,-2,-1,2,5,1
"1140",1140,148,7,"Antisocial","coughelbow",1,3,1,3,1,-2,-2,-2,5,1
"1141",1141,148,8,"Antisocial","redlights",3,5,2,5,3,-3,-2,-2,5,1
"1142",1142,148,9,"Prosocial","speed",10,8,10,5,7,2,2,2,5,1
"1143",1143,148,11,"Antisocial","shower",3,5,5,7,6,0,-1,-2,5,1
"1144",1144,148,12,"Prosocial","bike",10,8,8,1,2,0,1,2,5,1
"1145",1145,149,1,"Prosocial","sustainable",11,9,8,5,5,-1,0,2,2,1
"1146",1146,149,2,"Antisocial","heating",3,5,2,2,2,-3,0,-2,2,1
"1147",1147,149,3,"Prosocial","charity",11,9,10,5,7,1,2,2,2,1
"1148",1148,149,4,"Prosocial","vegetarian",10,8,7,6,5,-1,-1,2,2,1
"1149",1149,149,6,"Antisocial","garbage",3,5,3,5,1,-2,-4,-2,2,1
"1150",1150,149,8,"Prosocial","crossroad",11,9,8,2,4,-1,2,2,2,1
"1151",1151,149,9,"Antisocial","distance",1,3,1,7,1,-2,-6,-2,2,1
"1152",1152,149,10,"Antisocial","shower",4,6,6,7,5,0,-2,-2,2,1
"1153",1153,150,1,"Prosocial","queue",11,9,10,4,5,1,1,2,5,2
"1154",1154,150,2,"Prosocial","homeless",10,8,9,4,6,1,2,2,5,2
"1155",1155,150,3,"Prosocial","volunteer",11,9,11,5,6,2,1,2,5,2
"1156",1156,150,5,"Antisocial","heating",4,6,10,3,3,4,0,-2,5,2
"1157",1157,150,6,"Prosocial","ownbag",10,8,9,5,6,1,1,2,5,2
"1158",1158,150,10,"Antisocial","late",1,3,2,6,6,-1,0,-2,5,2
"1159",1159,150,11,"Antisocial","shower",5,7,8,7,6,1,-1,-2,5,2
"1160",1160,150,12,"Antisocial","lights",4,6,4,4,3,-2,-1,-2,5,2
"1161",1161,151,2,"Antisocial","lights",4,6,3,2,3,-3,1,-2,4,2
"1162",1162,151,3,"Prosocial","ownbag",8,6,10,3,5,4,2,2,4,2
"1163",1163,151,4,"Antisocial","shower",4,6,3,7,7,-3,0,-2,4,2
"1164",1164,151,7,"Prosocial","volunteer",10,8,8,5,5,0,0,2,4,2
"1165",1165,151,8,"Antisocial","distance",9,11,10,7,6,-1,-1,-2,4,2
"1166",1166,151,9,"Antisocial","redlights",1,3,1,4,3,-2,-1,-2,4,2
"1167",1167,151,10,"Prosocial","lendMoney",9,7,9,4,5,2,1,2,4,2
"1168",1168,151,11,"Prosocial","vegetarian",8,6,8,2,4,2,2,2,4,2
"1169",1169,152,1,"Prosocial","crossroad",10,8,10,1,5,2,4,2,3,1
"1170",1170,152,2,"Antisocial","late",3,5,4,2,1,-1,-1,-2,3,1
"1171",1171,152,3,"Prosocial","lendMoney",8,6,4,2,1,-2,-1,2,3,1
"1172",1172,152,4,"Antisocial","chargers",4,6,6,7,3,0,-4,-2,3,1
"1173",1173,152,5,"Antisocial","shower",3,5,5,6,5,0,-1,-2,3,1
"1174",1174,152,6,"Prosocial","sustainable",9,7,9,4,5,2,1,2,3,1
"1175",1175,152,7,"Prosocial","speed",8,6,8,3,6,2,3,2,3,1
"1176",1176,152,8,"Antisocial","distance",8,10,11,7,7,1,0,-2,3,1
"1177",1177,153,1,"Antisocial","noisedisturbance",4,6,6,5,4,0,-1,-2,6,2
"1178",1178,153,2,"Prosocial","homeless",10,8,11,5,6,3,1,2,6,2
"1179",1179,153,3,"Prosocial","bike",10,8,9,4,3,1,-1,2,6,2
"1180",1180,153,5,"Antisocial","gathering",4,6,6,5,5,0,0,-2,6,2
"1181",1181,153,6,"Antisocial","redlights",2,4,4,4,4,0,0,-2,6,2
"1182",1182,153,9,"Prosocial","charity",10,8,11,5,5,3,0,2,6,2
"1183",1183,153,10,"Prosocial","queue",10,8,8,3,2,0,-1,2,6,2
"1184",1184,153,12,"Antisocial","alcoholWork",2,4,2,5,2,-2,-3,-2,6,2
"1185",1185,154,1,"Prosocial","sustainable",11,9,6,4,5,-3,1,2,3,1
"1186",1186,154,3,"Antisocial","distance",4,6,6,4,4,0,0,-2,3,1
"1187",1187,154,4,"Prosocial","homeless",8,6,7,4,5,1,1,2,3,1
"1188",1188,154,5,"Antisocial","shower",4,6,7,5,5,1,0,-2,3,1
"1189",1189,154,6,"Antisocial","alcoholWork",5,7,3,5,3,-4,-2,-2,3,1
"1190",1190,154,7,"Prosocial","lendMoney",8,6,8,1,6,2,5,2,3,1
"1191",1191,154,8,"Prosocial","recycle",11,9,7,4,5,-2,1,2,3,1
"1192",1192,154,12,"Antisocial","travelticket",4,6,6,2,4,0,2,-2,3,1
"1193",1193,155,1,"Prosocial","lendMoney",8,6,6,2,4,0,2,2,1,2
"1194",1194,155,2,"Prosocial","seatBus",9,7,9,4,7,2,3,2,1,2
"1195",1195,155,4,"Prosocial","crossroad",8,6,7,5,5,1,0,2,1,2
"1196",1196,155,6,"Antisocial","meat",9,11,6,7,7,-5,0,-2,1,2
"1197",1197,155,7,"Prosocial","queue",8,6,7,5,6,1,1,2,1,2
"1198",1198,155,8,"Antisocial","heating",4,6,3,2,1,-3,-1,-2,1,2
"1199",1199,155,9,"Antisocial","shower",3,5,4,2,2,-1,0,-2,1,2
"1200",1200,155,11,"Antisocial","download",6,8,6,2,1,-2,-1,-2,1,2
"1201",1201,156,1,"Antisocial","late",4,6,4,2,3,-2,1,-2,3,1
"1202",1202,156,2,"Prosocial","vegetarian",10,8,9,2,5,1,3,2,3,1
"1203",1203,156,3,"Prosocial","homeless",10,8,9,1,3,1,2,2,3,1
"1204",1204,156,4,"Prosocial","bike",11,9,9,1,1,0,0,2,3,1
"1205",1205,156,6,"Antisocial","distance",4,6,6,7,6,0,-1,-2,3,1
"1206",1206,156,8,"Antisocial","chargers",4,6,6,7,7,0,0,-2,3,1
"1207",1207,156,10,"Antisocial","noisedisturbance",4,6,3,2,2,-3,0,-2,3,1
"1208",1208,156,12,"Prosocial","crossroad",11,9,10,5,6,1,1,2,3,1
"1209",1209,157,1,"Antisocial","shower",7,9,9,7,5,0,-2,-2,6,2
"1210",1210,157,3,"Prosocial","lendMoney",8,6,7,1,4,1,3,2,6,2
"1211",1211,157,5,"Antisocial","travelticket",1,3,1,1,1,-2,0,-2,6,2
"1212",1212,157,6,"Prosocial","homeless",6,4,6,1,4,2,3,2,6,2
"1213",1213,157,7,"Antisocial","heating",1,6,1,1,2,-5,1,-5,6,2
"1214",1214,157,8,"Antisocial","late",2,4,1,2,2,-3,0,-2,6,2
"1215",1215,157,10,"Prosocial","bike",9,7,11,1,3,4,2,2,6,2
"1216",1216,157,11,"Prosocial","washands",11,9,8,6,7,-1,1,2,6,2
"1217",1217,157,12,"Antisocial","meat",9,11,10,7,5,-1,-2,-2,6,2
"1218",1218,158,2,"Antisocial","shower",3,5,4,5,4,-1,-1,-2,5,2
"1219",1219,158,4,"Prosocial","lendMoney",8,6,10,4,5,4,1,2,5,2
"1220",1220,158,5,"Prosocial","speed",11,9,11,6,7,2,1,2,5,2
"1221",1221,158,8,"Antisocial","late",1,3,3,5,3,0,-2,-2,5,2
"1222",1222,158,9,"Antisocial","parking",2,4,1,2,1,-3,-1,-2,5,2
"1223",1223,158,10,"Prosocial","seatBus",11,9,11,4,7,2,3,2,5,2
"1224",1224,158,11,"Antisocial","chargers",3,5,4,4,4,-1,0,-2,5,2
"1225",1225,158,12,"Prosocial","volunteer",10,8,11,5,7,3,2,2,5,2
"1226",1226,159,1,"Antisocial","chargers",4,6,5,3,3,-1,0,-2,6,2
"1227",1227,159,3,"Prosocial","volunteer",11,9,10,2,7,1,5,2,6,2
"1228",1228,159,5,"Antisocial","late",1,3,4,3,3,1,0,-2,6,2
"1229",1229,159,6,"Antisocial","distance",8,10,1,7,1,-9,-6,-2,6,2
"1230",1230,159,7,"Antisocial","download",4,6,7,4,6,1,2,-2,6,2
"1231",1231,159,8,"Prosocial","lendMoney",11,9,11,5,7,2,2,2,6,2
"1232",1232,159,9,"Prosocial","bike",11,9,11,1,4,2,3,2,6,2
"1233",1233,159,11,"Prosocial","screentime",11,9,10,6,6,1,0,2,6,2
"1234",1234,160,1,"Prosocial","homeless",11,9,9,2,4,0,2,2,4,1
"1235",1235,160,2,"Prosocial","queue",11,9,6,4,4,-3,0,2,4,1
"1236",1236,160,4,"Antisocial","shower",1,3,2,4,2,-1,-2,-2,4,1
"1237",1237,160,6,"Antisocial","parking",4,6,1,6,1,-5,-5,-2,4,1
"1238",1238,160,7,"Prosocial","screentime",8,6,10,2,3,4,1,2,4,1
"1239",1239,160,8,"Antisocial","distance",2,4,1,5,2,-3,-3,-2,4,1
"1240",1240,160,9,"Antisocial","redlights",1,3,1,4,1,-2,-3,-2,4,1
"1241",1241,160,11,"Prosocial","lendMoney",8,6,6,1,3,0,2,2,4,1
"1242",1242,161,1,"Prosocial","screentime",8,6,6,3,3,0,0,2,6,2
"1243",1243,161,2,"Prosocial","speed",8,6,8,3,3,2,0,2,6,2
"1244",1244,161,3,"Prosocial","lendMoney",9,7,9,1,5,2,4,2,6,2
"1245",1245,161,5,"Antisocial","noisedisturbance",1,4,1,1,1,-3,0,-3,6,2
"1246",1246,161,6,"Antisocial","late",1,3,3,1,2,0,1,-2,6,2
"1247",1247,161,8,"Antisocial","shower",4,6,6,7,6,0,-1,-2,6,2
"1248",1248,161,11,"Antisocial","alcoholWork",4,6,6,2,4,0,2,-2,6,2
"1249",1249,161,12,"Prosocial","bike",11,9,8,2,2,-1,0,2,6,2
"1250",1250,162,2,"Prosocial","ownbag",11,9,11,4,7,2,3,2,4,1
"1251",1251,162,3,"Antisocial","travelticket",4,6,6,2,4,0,2,-2,4,1
"1252",1252,162,4,"Prosocial","vegetarian",8,6,3,1,4,-3,3,2,4,1
"1253",1253,162,5,"Antisocial","heating",1,3,1,2,1,-2,-1,-2,4,1
"1254",1254,162,7,"Prosocial","charity",8,6,6,1,2,0,1,2,4,1
"1255",1255,162,8,"Antisocial","cyberbully",3,5,6,3,3,1,0,-2,4,1
"1256",1256,162,9,"Prosocial","homeless",11,9,9,4,3,0,-1,2,4,1
"1257",1257,162,11,"Antisocial","shower",4,6,9,6,5,3,-1,-2,4,1
"1258",1258,163,1,"Antisocial","shower",3,5,3,7,7,-2,0,-2,4,2
"1259",1259,163,2,"Antisocial","heating",4,6,5,4,1,-1,-3,-2,4,2
"1260",1260,163,3,"Prosocial","speed",9,7,11,2,3,4,1,2,4,2
"1261",1261,163,4,"Prosocial","lendMoney",8,6,3,4,1,-3,-3,2,4,2
"1262",1262,163,7,"Prosocial","queue",11,9,7,5,5,-2,0,2,4,2
"1263",1263,163,8,"Antisocial","late",3,5,6,3,7,1,4,-2,4,2
"1264",1264,163,9,"Prosocial","sustainable",11,9,10,5,6,1,1,2,4,2
"1265",1265,163,10,"Antisocial","chargers",4,6,5,7,7,-1,0,-2,4,2
"1266",1266,164,3,"Antisocial","meat",9,11,10,7,7,-1,0,-2,6,2
"1267",1267,164,6,"Antisocial","download",7,9,6,7,5,-3,-2,-2,6,2
"1268",1268,164,7,"Prosocial","speed",8,6,8,4,4,2,0,2,6,2
"1269",1269,164,8,"Prosocial","sustainable",8,6,6,4,4,0,0,2,6,2
"1270",1270,164,9,"Antisocial","travelticket",6,8,6,7,4,-2,-3,-2,6,2
"1271",1271,164,10,"Antisocial","chargers",9,11,7,6,7,-4,1,-2,6,2
"1272",1272,164,11,"Prosocial","organicVegetables",8,6,11,4,7,5,3,2,6,2
"1273",1273,164,12,"Prosocial","queue",10,8,10,5,5,2,0,2,6,2
"1274",1274,165,1,"Prosocial","vegetarian",9,7,8,3,2,1,-1,2,4,1
"1275",1275,165,2,"Antisocial","lights",5,7,7,6,6,0,0,-2,4,1
"1276",1276,165,3,"Prosocial","volunteer",9,7,10,1,2,3,1,2,4,1
"1277",1277,165,5,"Antisocial","chargers",5,7,3,7,6,-4,-1,-2,4,1
"1278",1278,165,6,"Antisocial","distance",9,11,9,7,7,-2,0,-2,4,1
"1279",1279,165,7,"Prosocial","queue",4,2,3,1,1,1,0,2,4,1
"1280",1280,165,10,"Antisocial","meat",7,9,9,7,7,0,0,-2,4,1
"1281",1281,165,11,"Prosocial","bike",7,5,8,1,1,3,0,2,4,1
"1282",1282,166,1,"Prosocial","crossroad",8,6,2,1,4,-4,3,2,5,2
"1283",1283,166,2,"Prosocial","lendMoney",4,2,1,1,1,-1,0,2,5,2
"1284",1284,166,3,"Antisocial","distance",4,6,11,7,7,5,0,-2,5,2
"1285",1285,166,4,"Antisocial","meat",9,11,9,7,5,-2,-2,-2,5,2
"1286",1286,166,6,"Antisocial","download",8,11,8,6,6,-3,0,-3,5,2
"1287",1287,166,8,"Prosocial","homeless",5,1,2,1,2,1,1,4,5,2
"1288",1288,166,10,"Antisocial","chargers",9,11,10,7,7,-1,0,-2,5,2
"1289",1289,166,11,"Prosocial","queue",3,1,2,1,2,1,1,2,5,2
"1290",1290,167,1,"Prosocial","queue",6,4,6,4,3,2,-1,2,5,1
"1291",1291,167,2,"Prosocial","speed",11,9,11,4,6,2,2,2,5,1
"1292",1292,167,3,"Prosocial","lendMoney",6,4,6,3,2,2,-1,2,5,1
"1293",1293,167,5,"Antisocial","heating",4,6,4,2,1,-2,-1,-2,5,1
"1294",1294,167,6,"Antisocial","download",4,6,8,5,4,2,-1,-2,5,1
"1295",1295,167,10,"Prosocial","screentime",8,6,6,3,2,0,-1,2,5,1
"1296",1296,167,11,"Antisocial","late",4,6,4,4,2,-2,-2,-2,5,1
"1297",1297,167,12,"Antisocial","chargers",4,6,5,6,5,-1,-1,-2,5,1
"1298",1298,168,1,"Antisocial","late",1,3,1,2,1,-2,-1,-2,6,2
"1299",1299,168,2,"Prosocial","vegetarian",6,4,6,2,2,2,0,2,6,2
"1300",1300,168,3,"Antisocial","gathering",2,4,2,2,2,-2,0,-2,6,2
"1301",1301,168,4,"Antisocial","meat",7,9,8,7,6,-1,-1,-2,6,2
"1302",1302,168,7,"Prosocial","volunteer",9,7,9,2,5,2,3,2,6,2
"1303",1303,168,9,"Prosocial","crossroad",11,9,9,2,4,0,2,2,6,2
"1304",1304,168,10,"Antisocial","lights",1,3,2,3,2,-1,-1,-2,6,2
"1305",1305,168,12,"Prosocial","charity",11,9,10,4,6,1,2,2,6,2
"1306",1306,169,1,"Prosocial","homeless",10,8,9,4,3,1,-1,2,4,1
"1307",1307,169,3,"Antisocial","meat",7,9,8,7,6,-1,-1,-2,4,1
"1308",1308,169,4,"Antisocial","distance",6,8,7,6,6,-1,0,-2,4,1
"1309",1309,169,7,"Prosocial","speed",11,9,10,4,6,1,2,2,4,1
"1310",1310,169,8,"Prosocial","queue",6,4,5,2,2,1,0,2,4,1
"1312",1312,169,11,"Antisocial","download",6,8,6,6,5,-2,-1,-2,4,1
"1313",1313,169,12,"Antisocial","gathering",5,7,5,5,3,-2,-2,-2,4,1
